RD,TS_received,TS_sent,AK,RoundTrip,
192082,192150,2022-07-26_18-34-43-469673,192153,68,
197229,197253,2022-07-26_18-34-48-702129,197256,24,
202337,202361,2022-07-26_18-34-53-940002,202364,24,
207442,207532,2022-07-26_18-34-59-236293,207535,90,
212557,212625,2022-07-26_18-35-04-460503,212628,68,
217681,217706,2022-07-26_18-35-09-667952,217709,25,
222843,222869,2022-07-26_18-35-14-956963,222872,26,
227960,228038,2022-07-26_18-35-20-236562,228044,78,
233088,233113,2022-07-26_18-35-25-460562,233117,25,
238192,238288,2022-07-26_18-35-30-769575,238291,96,
243301,243325,2022-07-26_18-35-35-934109,243329,24,
248448,248482,2022-07-26_18-35-41-222853,248487,34,
253553,253579,2022-07-26_18-35-46-446321,253583,26,
258661,258690,2022-07-26_18-35-51-680740,258693,29,
263814,263890,2022-07-26_18-35-56-987875,263894,76,
268920,268948,2022-07-26_18-36-02-199855,268951,28,
274029,274053,2022-07-26_18-36-07-439250,274057,24,
279131,279243,2022-07-26_18-36-12-760546,284238,112,
284262,284340,2022-07-26_18-36-17-983550,284343,78,
289342,289368,2022-07-26_18-36-23-138009,289372,26,
294505,294533,2022-07-26_18-36-28-432720,294537,28,
299609,299726,2022-07-26_18-36-33-752830,304709,117,
304722,304746,2022-07-26_18-36-38-905038,304749,24,
309875,309913,2022-07-26_18-36-44-200771,309917,38,
315013,315039,2022-07-26_18-36-49-454816,315042,26,
320141,320164,2022-07-26_18-36-54-712987,320167,23,
325273,325312,2022-07-26_18-36-59-972871,325318,39,
330374,330397,2022-07-26_18-37-05-204957,330401,23,
335481,335506,2022-07-26_18-37-10-440790,335509,25,
340591,340682,2022-07-26_18-37-15-746945,340686,91,
345948,346071,2022-07-26_18-37-21-268995,351096,123,
351109,351162,2022-07-26_18-37-26-489385,351165,53,
356209,356232,2022-07-26_18-37-31-690537,356235,23,
361327,361351,2022-07-26_18-37-36-935888,361355,24,
366441,366465,2022-07-26_18-37-42-175819,366469,24,
371601,371657,2022-07-26_18-37-47-487606,371663,56,
376699,376726,2022-07-26_18-37-52-703569,376729,27,
381840,381868,2022-07-26_18-37-57-969502,381871,28,
386950,386974,2022-07-26_18-38-03-200405,386978,24,
392099,392130,2022-07-26_18-38-08-481781,392133,31,
397259,397318,2022-07-26_18-38-13-802198,397325,59,
402404,402428,2022-07-26_18-38-19-041884,402431,24,
407521,407601,2022-07-26_18-38-24-342596,407605,80,
412620,412697,2022-07-26_18-38-29-569613,412701,77,
417768,417796,2022-07-26_18-38-34-798898,417799,28,
422915,422939,2022-07-26_18-38-40-067333,422943,24,
428030,428079,2022-07-26_18-38-45-340857,428083,49,
433148,433178,2022-07-26_18-38-50-565518,433183,30,
438269,438293,2022-07-26_18-38-55-815780,438296,24,
443384,443453,2022-07-26_18-39-01-099649,443456,69,
448495,448520,2022-07-26_18-39-06-295667,448523,25,
453612,453636,2022-07-26_18-39-11-542838,453640,24,
458723,458749,2022-07-26_18-39-16-783722,458760,26,
463830,463858,2022-07-26_18-39-22-018133,463862,28,
468936,468959,2022-07-26_18-39-27-252512,468962,23,
474047,474122,2022-07-26_18-39-32-545770,474125,75,
479165,479228,2022-07-26_18-39-37-776775,479231,63,
484299,484324,2022-07-26_18-39-43-000912,484328,25,
489451,489501,2022-07-26_18-39-48-309923,489505,50,
494552,494599,2022-07-26_18-39-53-538089,494603,47,
499659,499683,2022-07-26_18-39-58-750605,499686,24,
504808,504836,2022-07-26_18-40-04-030008,504840,28,
509918,509942,2022-07-26_18-40-09-268649,509945,24,
515025,515048,2022-07-26_18-40-14-501850,515053,23,
520133,520157,2022-07-26_18-40-19-736827,520160,24,
525242,525270,2022-07-26_18-40-24-978926,525272,28,
530350,530376,2022-07-26_18-40-30-214299,530379,26,
535457,535482,2022-07-26_18-40-35-449092,535486,25,
540584,540608,2022-07-26_18-40-40-706978,540611,24,
545691,545716,2022-07-26_18-40-45-944654,545719,25,
550799,550824,2022-07-26_18-40-51-178949,550827,25,
555943,555966,2022-07-26_18-40-56-450334,555969,23,
561050,561077,2022-07-26_18-41-01-686044,561080,27,
566158,566174,2022-07-26_18-41-06-921320,566184,16,
571318,571342,2022-07-26_18-41-12-209953,571346,24,
576427,576456,2022-07-26_18-41-17-450889,576459,29,
581535,581559,2022-07-26_18-41-22-685941,581562,24,
586644,586667,2022-07-26_18-41-27-926828,586671,23,
591750,591774,2022-07-26_18-41-33-160986,591778,24,
596859,596882,2022-07-26_18-41-38-399173,596885,23,
601971,601995,2022-07-26_18-41-43-644636,601998,24,
607074,607098,2022-07-26_18-41-48-876828,607101,24,
612216,612238,2022-07-26_18-41-54-145023,612241,22,
617332,617357,2022-07-26_18-41-59-395763,617360,25,
622488,622517,2022-07-26_18-42-04-686763,622521,29,
627622,627647,2022-07-26_18-42-09-946448,627650,25,
632729,632752,2022-07-26_18-42-15-182306,632756,23,
637866,637892,2022-07-26_18-42-20-450019,637896,26,
643037,643060,2022-07-26_18-42-25-753218,643063,23,
648144,648169,2022-07-26_18-42-30-989074,648172,25,
653287,653315,2022-07-26_18-42-36-261934,653318,28,
658395,658420,2022-07-26_18-42-41-499338,658423,25,
663523,663548,2022-07-26_18-42-46-757901,663551,25,
668678,668703,2022-07-26_18-42-52-040105,668706,25,
673827,673852,2022-07-26_18-42-57-317249,673855,25,
678969,678991,2022-07-26_18-43-02-588672,678995,22,
684077,684100,2022-07-26_18-43-07-824854,684105,23,
689229,689255,2022-07-26_18-43-13-109271,689258,26,
694391,694416,2022-07-26_18-43-18-394799,694419,25,
699542,699569,2022-07-26_18-43-23-680543,699578,27,
704685,704709,2022-07-26_18-43-28-953622,704712,24,
709837,709862,2022-07-26_18-43-34-236200,709865,25,
714948,714972,2022-07-26_18-43-39-473830,714975,24,
720071,720100,2022-07-26_18-43-44-731490,720104,29,
725199,725224,2022-07-26_18-43-49-982604,725227,25,
730353,730422,2022-07-26_18-43-55-308457,730425,69,
735441,735511,2022-07-26_18-44-00-528206,735514,70,
740590,740617,2022-07-26_18-44-05-761747,740622,27,
745735,745802,2022-07-26_18-44-11-077950,745807,67,
750872,750897,2022-07-26_18-44-16-306685,750901,25,
755978,756003,2022-07-26_18-44-21-536203,756006,25,
761083,761111,2022-07-26_18-44-26-769815,761114,28,
766213,766250,2022-07-26_18-44-32-035708,766254,37,
771323,771347,2022-07-26_18-44-37-268217,771351,24,
776474,776498,2022-07-26_18-44-42-549023,776501,24,
781572,781657,2022-07-26_18-44-47-837693,781660,85,
786687,786749,2022-07-26_18-44-53-060140,786753,62,
791796,791854,2022-07-26_18-44-58-290486,791857,58,
796904,796941,2022-07-26_18-45-03-507124,796945,37,
802013,802047,2022-07-26_18-45-08-731083,802050,34,
807112,807138,2022-07-26_18-45-13-961140,807141,26,
812220,812316,2022-07-26_18-45-19-269148,812319,96,
817330,817355,2022-07-26_18-45-24-435173,817360,25,
822499,822524,2022-07-26_18-45-29-734593,822527,25,
827596,827622,2022-07-26_18-45-34-958382,827625,26,
832703,832727,2022-07-26_18-45-40-196409,832730,24,
837813,837889,2022-07-26_18-45-45-488492,837892,76,
842965,842990,2022-07-26_18-45-50-719079,842993,25,
848070,848094,2022-07-26_18-45-55-947565,848098,24,
853178,853201,2022-07-26_18-46-01-187025,853204,23,
858291,858315,2022-07-26_18-46-06-432740,858319,24,
863412,
868546,868571,2022-07-26_18-46-16-944257,868575,25,
873724,873748,2022-07-26_18-46-22-250393,873751,24,
878827,878852,2022-07-26_18-46-27-481651,878856,25,
883928,889034,2022-07-26_18-46-32-900243,889037,5106,
889037,889062,2022-07-26_18-46-37-950801,889065,25,
894203,894227,2022-07-26_18-46-43-248768,894230,24,
899303,899330,2022-07-26_18-46-48-478123,899334,27,
904425,904509,2022-07-26_18-46-53-786131,904513,84,
909541,909606,2022-07-26_18-46-59-008359,909609,65,
914662,914690,2022-07-26_18-47-04-224943,914694,28,
919775,919901,2022-07-26_18-47-09-561891,924878,126,
924901,924994,2022-07-26_18-47-14-785256,924997,93,
929989,930014,2022-07-26_18-47-19-933411,930017,25,
935085,935169,2022-07-26_18-47-25-222838,935172,84,
940220,940246,2022-07-26_18-47-30-423200,940249,26,
945330,945354,2022-07-26_18-47-35-661396,945357,24,
950448,950470,2022-07-26_18-47-40-911001,950473,22,
955554,955646,2022-07-26_18-47-46-215578,955649,92,
960720,960745,2022-07-26_18-47-51-443237,960748,25,
965822,965846,2022-07-26_18-47-56-674329,965849,24,
970938,970965,2022-07-26_18-48-01-920450,970968,27,
976056,976124,2022-07-26_18-48-07-207339,976128,68,
981186,981231,2022-07-26_18-48-12-439355,981236,45,
986293,986316,2022-07-26_18-48-17-657223,986320,23,
991452,991511,2022-07-26_18-48-22-984543,991515,59,
996550,996602,2022-07-26_18-48-28-204251,996606,52,
1001671,1001702,2022-07-26_18-48-33-426253,1001705,31,
1006775,1006802,2022-07-26_18-48-38-657027,1006806,27,
1011884,1011915,2022-07-26_18-48-43-897613,1011918,31,
1016991,1017083,2022-07-26_18-48-49-196257,1017089,92,
1022152,1022177,2022-07-26_18-48-54-419403,1022180,25,
1027257,1027282,2022-07-26_18-48-59-652946,1027285,25,
1032349,1032378,2022-07-26_18-49-04-870942,1032383,29,
1037469,1037561,2022-07-26_18-49-10-189393,1037564,92,
1042589,1042648,2022-07-26_18-49-15-407255,1042652,59,
1047693,1047720,2022-07-26_18-49-20-612541,1047724,27,
1052781,1052807,2022-07-26_18-49-25-825669,1052810,26,
1057956,1057980,2022-07-26_18-49-31-127268,1057983,24,
1063065,1063112,2022-07-26_18-49-36-385334,1063115,47,
1068216,1068241,2022-07-26_18-49-41-645738,1068245,25,
1073385,1073420,2022-07-26_18-49-46-950968,1073423,35,
1078491,1078517,2022-07-26_18-49-52-181508,1078520,26,
1083590,1083621,2022-07-26_18-49-57-417236,1083625,31,
1088726,1088751,2022-07-26_18-50-02-676685,1088755,25,
1093847,1093887,2022-07-26_18-50-07-938560,1093890,40,
1098957,1098982,2022-07-26_18-50-13-166169,1098985,25,
1104056,1104081,2022-07-26_18-50-18-395695,1104084,25,
1109171,1109268,2022-07-26_18-50-23-716601,1109272,97,
1114270,1114294,2022-07-26_18-50-28-868749,1114297,24,
1119408,
1124557,1124582,2022-07-26_18-50-39-411847,1124586,25,
1129682,1129707,2022-07-26_18-50-44-668273,1129709,25,
1134826,1134852,2022-07-26_18-50-49-942873,1134856,26,
1139967,1140050,2022-07-26_18-50-55-270238,1140054,83,
1145073,1145142,2022-07-26_18-51-00-480310,1145148,69,
1150194,1150219,2022-07-26_18-51-05-697474,1150223,25,
1155317,1155437,2022-07-26_18-51-11-016820,1160478,120,
1160493,1160588,2022-07-26_18-51-16-256672,1160592,95,
1165583,1165608,2022-07-26_18-51-21-475245,1165612,25,
1170702,1170727,2022-07-26_18-51-26-719395,1170730,25,
1175819,1175914,2022-07-26_18-51-32-020789,1175920,95,
1180927,1181002,2022-07-26_18-51-37-245682,1181010,75,
1186032,1186081,2022-07-26_18-51-42-459320,1186084,49,
1191133,1191154,2022-07-26_18-51-47-661936,1191158,21,
1196247,1196274,2022-07-26_18-51-52-907207,1196277,27,
1201351,1201375,2022-07-26_18-51-58-136676,1201378,24,
1206493,1206517,2022-07-26_18-52-03-409788,1206520,24,
1211588,1211613,2022-07-26_18-52-08-632078,1211616,25,
1216762,1216786,2022-07-26_18-52-13-936102,1216790,24,
1221936,1221959,2022-07-26_18-52-19-240214,1221962,23,
1227094,1227117,2022-07-26_18-52-24-529268,1227120,23,
1232201,1232229,2022-07-26_18-52-29-769661,1232233,28,
1237391,1237443,2022-07-26_18-52-35-088317,1237449,52,
1242553,1242636,2022-07-26_18-52-40-427529,1242642,83,
1247695,1247719,2022-07-26_18-52-45-648582,1247723,24,
1252807,1252832,2022-07-26_18-52-50-889990,1252835,25,
1257923,1257986,2022-07-26_18-52-56-177255,1257990,63,
1263037,1263086,2022-07-26_18-53-01-405300,1263089,49,
1268144,1268210,2022-07-26_18-53-06-643858,1268216,66,
1273269,1273293,2022-07-26_18-53-11-867517,1273296,24,
1278384,1283529,2022-07-26_18-53-17-168469,1283540,5145,
1283553,1283579,2022-07-26_18-53-22-413025,1283583,26,
1288640,1288667,2022-07-26_18-53-27-634557,1288670,27,
1293748,1293774,2022-07-26_18-53-32-864452,1293778,26,
1298855,1298880,2022-07-26_18-53-38-098962,1298883,25,
1303987,1304014,2022-07-26_18-53-43-366529,1304018,27,
1309096,1309120,2022-07-26_18-53-48-599240,1309123,24,
1314241,1314272,2022-07-26_18-53-53-876901,1314275,31,
1319348,1319371,2022-07-26_18-53-59-112285,1319374,23,
1324456,1324482,2022-07-26_18-54-04-348925,1324485,26,
1329565,1329592,2022-07-26_18-54-09-586730,1329596,27,
1334673,1334697,2022-07-26_18-54-14-820008,1334700,24,
1339824,1339849,2022-07-26_18-54-20-101763,1339853,25,
1344936,1344960,2022-07-26_18-54-25-342515,1344964,24,
1350044,1350082,2022-07-26_18-54-30-588665,1350086,38,
1355151,1355175,2022-07-26_18-54-35-812413,1355178,24,
1360260,1360282,2022-07-26_18-54-41-049954,1360286,22,
1365408,1365431,2022-07-26_18-54-46-329546,1365434,23,
1370516,1370542,2022-07-26_18-54-51-566674,1370545,26,
1375624,1375650,2022-07-26_18-54-56-807776,1375653,26,
1380798,1380835,2022-07-26_18-55-02-113372,1380838,37,
1385905,1385930,2022-07-26_18-55-07-342556,1385933,25,
1391015,1391039,2022-07-26_18-55-12-578923,1391043,24,
1396169,1396193,2022-07-26_18-55-17-863838,1396197,24,
1401334,1401356,2022-07-26_18-55-23-157358,1401360,22,
1406444,1406467,2022-07-26_18-55-28-399938,1406471,23,
1411551,1411576,2022-07-26_18-55-33-635237,1411579,25,
1416661,1416685,2022-07-26_18-55-38-872052,1416689,24,
1421768,1421791,2022-07-26_18-55-44-108883,1421796,23,
1426912,1426941,2022-07-26_18-55-49-386056,1426944,29,
1432073,1432101,2022-07-26_18-55-54-675623,1432104,28,
1437205,1437228,2022-07-26_18-55-59-933951,1437232,23,
1442336,1442358,2022-07-26_18-56-05-194164,1442362,22,
1447469,1452622,2022-07-26_18-56-10-554959,1452627,5153,
1452627,1452664,2022-07-26_18-56-15-750551,1452667,37,
1457774,1457799,2022-07-26_18-56-21-022218,1457802,25,
1462903,1462928,2022-07-26_18-56-26-279701,1462931,25,
1468047,1468087,2022-07-26_18-56-31-564410,1468090,40,
1473169,1473192,2022-07-26_18-56-36-799563,1473196,23,
1478310,1478336,2022-07-26_18-56-42-071776,1478340,26,
1483438,1483463,2022-07-26_18-56-47-331006,1483467,25,
1488600,1488625,2022-07-26_18-56-52-622490,1488629,25,
1493720,1493743,2022-07-26_18-56-57-867332,1493747,23,
1498823,1498935,2022-07-26_18-57-03-180763,1503926,112,
1503947,1504027,2022-07-26_18-57-08-403367,1504030,80,
1509049,1509113,2022-07-26_18-57-13-619884,1509117,64,
1514133,1514158,2022-07-26_18-57-18-794763,1514162,25,
1519301,1519325,2022-07-26_18-57-24-093677,1519328,24,
1524438,1524461,2022-07-26_18-57-29-360735,1524465,23,
1529569,1529592,2022-07-26_18-57-34-618839,1529596,23,
1534680,1534792,2022-07-26_18-57-39-942664,1539800,112,
1539813,1539836,2022-07-26_18-57-45-125117,1539839,23,
1544898,1544993,2022-07-26_18-57-50-392994,1544999,95,
1550058,1550085,2022-07-26_18-57-55-626249,1550089,27,
1555165,1555190,2022-07-26_18-58-00-864853,1555195,25,
1560283,1560347,2022-07-26_18-58-06-150583,1560350,64,
1565369,1565447,2022-07-26_18-58-11-378107,1565451,78,
1570513,1570538,2022-07-26_18-58-16-595135,1570541,25,
1575624,1575649,2022-07-26_18-58-21-839204,1575652,25,
1580731,1580831,2022-07-26_18-58-27-148182,1580837,100,
1585904,1585928,2022-07-26_18-58-32-373648,1585931,24,
1591077,1591100,2022-07-26_18-58-37-678287,1591104,23,
1596199,1596225,2022-07-26_18-58-42-930310,1596229,26,
1601336,1601403,2022-07-26_18-58-48-237522,1601406,67,
1606449,1606501,2022-07-26_18-58-53-460637,1606504,52,
1611572,1611595,2022-07-26_18-58-58-689931,1611599,23,
1616673,1616697,2022-07-26_18-59-03-918668,1616701,24,
1621812,1621837,2022-07-26_18-59-09-186714,1621840,25,
1626930,1626998,2022-07-26_18-59-14-474164,1627003,68,
1632058,1632081,2022-07-26_18-59-19-685099,1632084,23,
1637213,1637275,2022-07-26_18-59-25-008890,1637282,62,
1642320,1642346,2022-07-26_18-59-30-207656,1642349,26,
1647430,1647457,2022-07-26_18-59-35-445848,1647461,27,
1652600,1652646,2022-07-26_18-59-40-769425,1652649,46,
1657728,1657751,2022-07-26_18-59-46-006023,1657754,23,
1662874,1662935,2022-07-26_18-59-51-317040,1662939,61,
1667979,1668035,2022-07-26_18-59-56-539820,1668039,56,
1673116,1673162,2022-07-26_19-00-01-802198,1673165,46,
1678289,1678315,2022-07-26_19-00-07-086858,1678318,26,
1683391,1683418,2022-07-26_19-00-12-318960,1683422,27,
1688497,1688533,2022-07-26_19-00-17-554281,1688537,36,
1693608,1693696,2022-07-26_19-00-22-855708,1693699,88,
1698754,1698799,2022-07-26_19-00-28-085845,1698803,45,
1703863,1703892,2022-07-26_19-00-33-307925,1703895,29,
1708966,1708989,2022-07-26_19-00-38-534398,1708993,23,
1714082,1714106,2022-07-26_19-00-43-779760,1714110,24,
1719238,1719281,2022-07-26_19-00-49-082098,1719285,43,
1724346,1724379,2022-07-26_19-00-54-301714,1724384,33,
1729450,1729473,2022-07-26_19-00-59-531077,1729477,23,
1734552,1734575,2022-07-26_19-01-04-766445,1734578,23,
1739661,1739744,2022-07-26_19-01-10-067698,1739747,83,
1744798,1744844,2022-07-26_19-01-15-292595,1744848,46,
1749923,
1755068,1760228,2022-07-26_19-01-26-159266,1760233,5160,
1760233,1765370,2022-07-26_19-01-31-500778,1765380,5137,
1765394,1765419,2022-07-26_19-01-36-387307,1765422,25,
1770491,1770519,2022-07-26_19-01-41-616132,1770522,28,
1775593,1775627,2022-07-26_19-01-46-841206,1775632,34,
1780699,
1785801,1790917,2022-07-26_19-01-57-411699,1790931,5116,
1790956,1790988,2022-07-26_19-02-02-594681,1790991,32,
1796059,1796084,2022-07-26_19-02-07-823205,1796088,25,
1801162,1801186,2022-07-26_19-02-13-052446,1801189,24,
1806267,1806294,2022-07-26_19-02-18-290156,1806298,27,
1811410,1811436,2022-07-26_19-02-23-560657,1811441,26,
1816540,1816567,2022-07-26_19-02-28-815019,1816570,27,
1821640,1821672,2022-07-26_19-02-34-044849,1821675,32,
1826771,1826795,2022-07-26_19-02-39-307383,1826799,24,
1831889,1831951,2022-07-26_19-02-44-585928,1831955,62,
1836995,1837041,2022-07-26_19-02-49-808132,1837044,46,
1842103,1842133,2022-07-26_19-02-55-025946,1842137,30,
1847207,1847324,2022-07-26_19-03-00-352771,1852353,117,
1852375,1852429,2022-07-26_19-03-05-581500,1852435,54,
1857469,1857507,2022-07-26_19-03-10-791867,1857511,38,
1862606,1862630,2022-07-26_19-03-16-041097,1862634,24,
1867756,1867804,2022-07-26_19-03-21-348097,1867807,48,
1872896,1872921,2022-07-26_19-03-26-593271,1872924,25,
1878051,1878093,2022-07-26_19-03-31-895175,1878100,42,
1883190,
1888312,1888336,2022-07-26_19-03-42-399424,1888340,24,
1893501,1893526,2022-07-26_19-03-47-717680,1893529,25,
1898645,1898677,2022-07-26_19-03-53-000144,1898680,32,
1903756,1903863,2022-07-26_19-03-58-315270,1908883,107,
1908903,1908952,2022-07-26_19-04-03-534953,1908955,49,
1914004,1914044,2022-07-26_19-04-08-756982,1914048,40,
1919139,1919164,2022-07-26_19-04-14-002069,1919167,25,
1924306,1924343,2022-07-26_19-04-19-306795,1924349,37,
1929412,1929436,2022-07-26_19-04-24-532192,1929440,24,
1934514,1934537,2022-07-26_19-04-29-760198,1934540,23,
1939701,1939725,2022-07-26_19-04-35-079190,1939729,24,
1944896,1944919,2022-07-26_19-04-40-407277,1944923,23,
1950007,
1955127,1955155,2022-07-26_19-04-50-895389,1955158,28,
1960256,1960302,2022-07-26_19-04-56-169708,1960308,46,
1965367,1965390,2022-07-26_19-05-01-397589,1965394,23,
1970473,1970497,2022-07-26_19-05-06-633786,1970500,24,
1975610,1980744,2022-07-26_19-05-13-309846,1980747,5134,
1980747,
1985861,1985886,2022-07-26_19-05-22-409528,1985889,25,
1990982,1991009,2022-07-26_19-05-27-658221,1991013,27,
1996139,1996186,2022-07-26_19-05-32-965994,1996189,47,
2001247,2001271,2022-07-26_19-05-38-178743,2001274,24,
2006419,2006442,2022-07-26_19-05-43-482677,2006445,23,
2011527,2011550,2022-07-26_19-05-48-720957,2011554,23,
2016673,2016697,2022-07-26_19-05-53-996433,2016700,24,
2021779,2021827,2022-07-26_19-05-59-250295,2021830,48,
2026943,2026966,2022-07-26_19-06-04-525902,2026970,23,
2032081,2032106,2022-07-26_19-06-09-794602,2032110,25,
2037186,2037212,2022-07-26_19-06-15-025190,2037215,26,
2042332,2042354,2022-07-26_19-06-20-299066,2042358,22,
2047439,2047463,2022-07-26_19-06-25-536908,2047466,24,
2052549,2052571,2022-07-26_19-06-30-771828,2052574,22,
2057693,2057716,2022-07-26_19-06-36-048635,2057719,23,
2062788,2062811,2022-07-26_19-06-41-269241,2062814,23,
2067909,2067932,2022-07-26_19-06-46-518429,2067935,23,
2073016,2073039,2022-07-26_19-06-51-756112,2073043,23,
2078125,2078149,2022-07-26_19-06-56-993247,2078153,24,
2083233,2083259,2022-07-26_19-07-02-231895,2083262,26,
2088342,2088366,2022-07-26_19-07-07-467824,2088369,24,
2093461,2093485,2022-07-26_19-07-12-713271,2093488,24,
2098588,2098612,2022-07-26_19-07-17-972167,2098616,24,
2103702,2103726,2022-07-26_19-07-23-217037,2103730,24,
2108803,2108828,2022-07-26_19-07-28-445923,2108831,25,
2113911,2113934,2022-07-26_19-07-33-684203,2113937,23,
2119054,2119081,2022-07-26_19-07-38-957178,2119084,27,
2124162,2124186,2022-07-26_19-07-44-194755,2124190,24,
2129270,2129300,2022-07-26_19-07-49-432881,2129303,30,
2134394,2134421,2022-07-26_19-07-54-685628,2134424,27,
2139605,2139629,2022-07-26_19-08-00-025098,2139632,24,
2144730,2144755,2022-07-26_19-08-05-280875,2144758,25,
2149885,2149923,2022-07-26_19-08-10-571711,2149926,38,
2154985,2155011,2022-07-26_19-08-15-795298,2155014,26,
2160107,2160131,2022-07-26_19-08-21-045574,2160134,24,
2165214,2165238,2022-07-26_19-08-26-283403,2165242,24,
2170321,2170349,2022-07-26_19-08-31-519741,2170353,28,
2175463,2175488,2022-07-26_19-08-36-785853,2175491,25,
2180573,2180601,2022-07-26_19-08-42-023705,2180605,28,
2185681,2185707,2022-07-26_19-08-47-263753,2185710,26,
2190787,2190814,2022-07-26_19-08-52-495985,2190817,27,
2195897,2195920,2022-07-26_19-08-57-734555,2195924,23,
2201006,2201030,2022-07-26_19-09-02-973712,2201033,24,
2206112,2206136,2022-07-26_19-09-08-207845,2206139,24,
2211221,2211247,2022-07-26_19-09-13-444823,2211250,26,
2216328,2216352,2022-07-26_19-09-18-683629,2216355,24,
2221437,2221472,2022-07-26_19-09-23-923937,2221476,35,
2226551,2226576,2022-07-26_19-09-29-163143,2226579,25,
2231662,2231686,2022-07-26_19-09-34-404920,2231691,24,
2236822,2236846,2022-07-26_19-09-39-692054,2236849,24,
2241962,2241987,2022-07-26_19-09-44-962766,2241991,25,
2247112,2247135,2022-07-26_19-09-50-238206,2247139,23,
2252248,2252349,2022-07-26_19-09-55-584171,2252352,101,
2257388,2257411,2022-07-26_19-10-00-775424,2257415,23,
2262505,2262537,2022-07-26_19-10-06-028623,2262541,32,
2267614,2267639,2022-07-26_19-10-11-258829,2267642,25,
2272757,2272785,2022-07-26_19-10-16-527875,2272789,28,
2277909,2277933,2022-07-26_19-10-21-811370,2277936,24,
2283013,2283047,2022-07-26_19-10-27-051186,2283052,34,
2288122,2288184,2022-07-26_19-10-32-284022,2288188,62,
2293284,2293312,2022-07-26_19-10-37-575087,2293315,28,
2298387,2298411,2022-07-26_19-10-42-806043,2298414,24,
2303500,2303598,2022-07-26_19-10-48-124439,2303601,98,
2308599,2308626,2022-07-26_19-10-53-276786,2308630,27,
2313748,2313781,2022-07-26_19-10-58-560875,2313784,33,
2318893,2318918,2022-07-26_19-11-03-832435,2318921,25,
2324032,2324076,2022-07-26_19-11-09-115584,2324080,44,
2329129,2329160,2022-07-26_19-11-14-324197,2329164,31,
2334243,2334266,2022-07-26_19-11-19-563648,2334270,23,
2339348,2344474,2022-07-26_19-11-24-988337,2344477,5126,
2344477,2344501,2022-07-26_19-11-30-057782,2344504,24,
2349639,2349740,2022-07-26_19-11-35-425760,2349743,101,
2354805,2354836,2022-07-26_19-11-40-649697,2354839,31,
2359908,2359935,2022-07-26_19-11-45-881146,2359938,27,
2365090,2365124,2022-07-26_19-11-51-202347,2365128,34,
2370194,2370219,2022-07-26_19-11-56-423795,2370222,25,
2375356,2375407,2022-07-26_19-12-01-746915,2375410,51,
2380464,2380517,2022-07-26_19-12-06-977757,2380523,53,
2385573,2385608,2022-07-26_19-12-12-198650,2385615,35,
2390684,2390707,2022-07-26_19-12-17-430227,2390711,23,
2395795,2395825,2022-07-26_19-12-22-677041,2395828,30,
2400915,2400941,2022-07-26_19-12-27-919064,2400944,26,
2406033,2406078,2022-07-26_19-12-33-186535,2406081,45,
2411138,2411172,2022-07-26_19-12-38-407370,2411177,34,
2416290,2416317,2022-07-26_19-12-43-683502,2416320,27,
2421405,2421467,2022-07-26_19-12-48-959140,2421473,62,
2426516,2426544,2022-07-26_19-12-54-171663,2426546,28,
2431621,2431645,2022-07-26_19-12-59-400304,2431648,24,
2436735,2436757,2022-07-26_19-13-04-639701,2436760,22,
2441884,2441923,2022-07-26_19-13-09-934986,2441926,39,
2447057,2447081,2022-07-26_19-13-15-223880,2447085,24,
2452241,2452316,2022-07-26_19-13-20-590619,2452319,75,
2457368,2457417,2022-07-26_19-13-25-818569,2457420,49,
2462476,2462554,2022-07-26_19-13-31-081338,2462558,78,
2467582,2472686,2022-07-26_19-13-36-365282,2472702,5104,
2472726,2472799,2022-07-26_19-13-41-590584,2472802,73,
2477793,2477819,2022-07-26_19-13-46-737897,2477822,26,
2482909,2482984,2022-07-26_19-13-52-027783,2482987,75,
2488028,2488052,2022-07-26_19-13-57-227523,2488057,24,
2493150,2493175,2022-07-26_19-14-02-479422,2493179,25,
2498261,2503382,2022-07-26_19-14-07-905660,2503387,5121,
2503388,2503482,2022-07-26_19-14-13-029610,2503487,94,
2508496,2508551,2022-07-26_19-14-18-242756,2508554,55,
2513610,2513669,2022-07-26_19-14-23-482162,2513675,59,
2518732,2518757,2022-07-26_19-14-28-707336,2518760,25,
2523843,2523930,2022-07-26_19-14-34-012159,2523933,87,
2528947,2529030,2022-07-26_19-14-39-241115,2529033,83,
2534078,2534101,2022-07-26_19-14-44-442375,2534104,23,
2539193,2539237,2022-07-26_19-14-49-691097,2539242,44,
2544295,2544320,2022-07-26_19-14-54-916919,2544323,25,
2549400,2549426,2022-07-26_19-15-00-153060,2549429,26,
2554518,2554589,2022-07-26_19-15-05-445669,2554592,71,
2559660,2559683,2022-07-26_19-15-10-666165,2559686,23,
2564767,2564793,2022-07-26_19-15-15-902960,2564796,26,
2569865,2569888,2022-07-26_19-15-21-130812,2569891,23,
2575025,2575050,2022-07-26_19-15-26-419134,2575053,25,
2580143,2580177,2022-07-26_19-15-31-671111,2580181,34,
2585244,2585272,2022-07-26_19-15-36-902646,2585276,28,
2590349,2590374,2022-07-26_19-15-42-131519,2590377,25,
2595519,2595556,2022-07-26_19-15-47-442171,2595559,37,
2600627,2600650,2022-07-26_19-15-52-667986,2600653,23,
2605737,2605843,2022-07-26_19-15-57-989572,2610840,106,
2610854,2610883,2022-07-26_19-16-03-157874,2610886,29,
2615952,2616031,2022-07-26_19-16-08-432336,2616034,79,
2621209,2626353,2022-07-26_19-16-13-962405,2626357,5144,
2626357,2626380,2022-07-26_19-16-19-048436,2626384,23,
2631476,2631512,2022-07-26_19-16-24-303190,2631515,36,
2636579,2636603,2022-07-26_19-16-29-529719,2636607,24,
2641683,2641706,2022-07-26_19-16-34-761544,2641709,23,
2646791,2646880,2022-07-26_19-16-40-067620,2646883,89,
2651897,2651981,2022-07-26_19-16-45-296021,2651984,84,
2657022,2657046,2022-07-26_19-16-50-486646,2657049,24,
2662130,2662156,2022-07-26_19-16-55-724758,2662160,26,
2667290,2667315,2022-07-26_19-17-01-015347,2667318,25,
2672441,2672466,2022-07-26_19-17-06-293490,2672470,25,
2677589,2677631,2022-07-26_19-17-11-571151,2677634,42,
2682744,2682844,2022-07-26_19-17-16-932857,2682850,100,
2687900,2687942,2022-07-26_19-17-22-162298,2687945,42,
2693007,2693034,2022-07-26_19-17-27-381910,2693037,27,
2698157,2698182,2022-07-26_19-17-32-658443,2698185,25,
2703304,2703331,2022-07-26_19-17-37-936806,2703334,27,
2708466,2708517,2022-07-26_19-17-43-257064,2708520,51,
2713591,2713619,2022-07-26_19-17-48-486641,2713622,28,
2718690,2718734,2022-07-26_19-17-53-718942,2718737,44,
2723797,2723820,2022-07-26_19-17-58-944318,2723823,23,
2728932,2728988,2022-07-26_19-18-04-242131,2728992,56,
2734041,2734092,2022-07-26_19-18-09-473225,2734095,51,
2739150,2739182,2022-07-26_19-18-14-691252,2739185,32,
2744255,2744294,2022-07-26_19-18-19-922343,2744301,39,
2749357,2749380,2022-07-26_19-18-25-151119,2749383,23,
2754467,2754558,2022-07-26_19-18-30-457153,2754561,91,
2759635,2759664,2022-07-26_19-18-35-686770,2759668,29,
2764734,2764757,2022-07-26_19-18-40-914952,2764760,23,
2769886,2774984,2022-07-26_19-18-46-994774,2775000,5098,
2775016,2775044,2022-07-26_19-18-51-457146,2775048,28,
2780093,2780134,2022-07-26_19-18-56-676385,2780137,41,
2785209,2785331,2022-07-26_19-19-02-003340,2790319,122,
2790332,2790423,2022-07-26_19-19-07-223070,2790430,91,
2795429,2795453,2022-07-26_19-19-12-380952,2795456,24,
2800538,2800564,2022-07-26_19-19-17-620602,2800569,26,
2805655,2805703,2022-07-26_19-19-22-890222,2805706,48,
2810764,2810805,2022-07-26_19-19-28-113897,2810811,41,
2815881,2820981,2022-07-26_19-19-33-508001,2820986,5100,
2820986,2821009,2022-07-26_19-19-38-582725,2821012,23,
2826102,2826176,2022-07-26_19-19-43-878766,2826179,74,
2831209,2831274,2022-07-26_19-19-49-104858,2831277,65,
2836319,2836369,2022-07-26_19-19-54-329788,2836373,50,
2841443,2841468,2022-07-26_19-19-59-555401,2841471,25,
2846675,2846760,2022-07-26_19-20-04-981297,2846763,85,
2851794,2851818,2022-07-26_19-20-10-168224,2851823,24,
2856916,2856954,2022-07-26_19-20-15-428142,2856957,38,
2862324,2862347,2022-07-26_19-20-20-960711,2862351,23,
2867431,2867534,2022-07-26_19-20-26-276503,2867540,103,
2872554,2872624,2022-07-26_19-20-31-494443,2872628,70,
2877710,2877734,2022-07-26_19-20-36-734892,2877738,24,
2882862,2887994,2022-07-26_19-20-42-171516,2888010,5132,
2888024,2888050,2022-07-26_19-20-47-314156,2888054,26,
2893104,2893129,2022-07-26_19-20-52-515761,2893132,25,
2898224,2898299,2022-07-26_19-20-57-812956,2898303,75,
2903321,2903392,2022-07-26_19-21-03-039581,2903395,71,
2908433,2908460,2022-07-26_19-21-08-234972,2908464,27,
2913541,2913565,2022-07-26_19-21-13-472948,2913571,24,
2918712,2918801,2022-07-26_19-21-18-817252,2918804,89,
2923814,2923837,2022-07-26_19-21-24-002240,2923840,23,
2928931,2928964,2022-07-26_19-21-29-253581,2928968,33,
2934034,2934062,2022-07-26_19-21-34-485530,2934066,28,
2939138,2939162,2022-07-26_19-21-39-713105,2939166,24,
2944251,2944338,2022-07-26_19-21-45-018165,2944341,87,
2949391,2949440,2022-07-26_19-21-50-248639,2949444,49,
2954496,2954536,2022-07-26_19-21-55-468661,2954539,40,
2959601,2959627,2022-07-26_19-22-00-690105,2959630,26,
2964799,2964824,2022-07-26_19-22-06-020513,2964828,25,
2969970,2969995,2022-07-26_19-22-11-318274,2970000,25,
2975136,2975218,2022-07-26_19-22-16-669690,2975222,82,
2980269,2980309,2022-07-26_19-22-21-890099,2980313,40,
2985380,2985404,2022-07-26_19-22-27-113180,2985407,24,
2990483,2990518,2022-07-26_19-22-32-345596,2990523,35,
2995634,2995657,2022-07-26_19-22-37-626754,2995661,23,
3000751,3000784,2022-07-26_19-22-42-883649,3000788,33,
3005857,3005977,2022-07-26_19-22-48-205247,3010956,120,
3010970,3011067,2022-07-26_19-22-53-422075,3011070,97,
3016082,3016108,2022-07-26_19-22-58-589688,3016112,26,
3021229,3021263,2022-07-26_19-23-03-872089,3021266,34,
3026328,3026355,2022-07-26_19-23-09-096595,3026358,27,
3031484,3031508,2022-07-26_19-23-14-379231,3031511,24,
3036601,3036641,2022-07-26_19-23-19-641476,3036645,40,
3041709,3041736,2022-07-26_19-23-24-865726,3041740,27,
3046811,3046838,2022-07-26_19-23-30-094553,3046841,27,
3051915,3051940,2022-07-26_19-23-35-324253,3051943,25,
3057023,3057047,2022-07-26_19-23-40-564951,3057051,24,
3062171,3062211,2022-07-26_19-23-45-861607,3062215,40,
3067277,3067302,2022-07-26_19-23-51-078759,3067305,25,
3072381,3072422,2022-07-26_19-23-56-309293,3072428,41,
3077485,3077512,2022-07-26_19-24-01-538387,3077515,27,
3082593,3082618,2022-07-26_19-24-06-776830,3082622,25,
3087703,3087788,2022-07-26_19-24-12-071127,3087793,85,
3092840,3092881,2022-07-26_19-24-17-297194,3092884,41,
3097949,3097976,2022-07-26_19-24-22-517399,3097980,27,
3103055,3103090,2022-07-26_19-24-27-748848,3103096,35,
3108177,3108266,2022-07-26_19-24-33-060477,3108271,89,
3113272,3113300,2022-07-26_19-24-38-226794,3113309,28,
3118388,3118449,2022-07-26_19-24-43-509127,3118455,61,
3123488,3123513,2022-07-26_19-24-48-700151,3123516,25,
3128605,3128635,2022-07-26_19-24-53-953509,3128639,30,
3133711,3133738,2022-07-26_19-24-59-180956,3133742,27,
3138877,3138936,2022-07-26_19-25-04-503972,3138942,59,
3143985,3144019,2022-07-26_19-25-09-718337,3144023,34,
3149092,3149136,2022-07-26_19-25-14-952462,3149142,44,
3154194,3154219,2022-07-26_19-25-20-180520,3154222,25,
3159330,3159354,2022-07-26_19-25-25-445115,3159357,24,
3164445,3164482,2022-07-26_19-25-30-701384,3164486,37,
3169553,3169595,2022-07-26_19-25-35-941460,3169599,42,
3174652,3174684,2022-07-26_19-25-41-160029,3174687,32,
3179760,3179881,2022-07-26_19-25-46-486972,3184864,121,
3184880,3184903,2022-07-26_19-25-51-638704,3184907,23,
3189977,3190002,2022-07-26_19-25-56-866175,3190005,25,
3195121,3195175,2022-07-26_19-26-02-158930,3195180,54,
3200229,3200284,2022-07-26_19-26-07-388564,3200290,55,
3205334,3205372,2022-07-26_19-26-12-607757,3205378,38,
3210437,3210464,2022-07-26_19-26-17-838951,3210467,27,
3215561,3215586,2022-07-26_19-26-23-093185,3215589,25,
3220724,3220754,2022-07-26_19-26-28-386482,3220757,30,
3225877,3225902,2022-07-26_19-26-33-666971,3225906,25,
3230994,3231029,2022-07-26_19-26-38-919409,3231032,35,
3236096,3241197,2022-07-26_19-26-44-345071,3241200,5101,
3241200,3241235,2022-07-26_19-26-49-381897,3241238,35,
3246308,3246332,2022-07-26_19-26-54-616870,3246335,24,
3251424,3251495,2022-07-26_19-26-59-906863,3251498,71,
3256532,3256589,2022-07-26_19-27-05-129320,3256592,57,
3261642,3261684,2022-07-26_19-27-10-351747,3261687,42,
3266749,3266778,2022-07-26_19-27-15-573842,3266781,29,
3271854,3271879,2022-07-26_19-27-20-803930,3271882,25,
3277026,3277069,2022-07-26_19-27-26-124234,3277072,43,
3282136,3282181,2022-07-26_19-27-31-365505,3282184,45,
3287251,3287351,2022-07-26_19-27-36-668044,3287355,100,
3292349,3292373,2022-07-26_19-27-41-815706,3292376,24,
3297467,3297541,2022-07-26_19-27-47-112926,3297544,74,
3302575,3302634,2022-07-26_19-27-52-336289,3302637,59,
3307709,3307733,2022-07-26_19-27-57-568919,3307737,24,
3312813,3312843,2022-07-26_19-28-02-803631,3312847,30,
3317926,3317959,2022-07-26_19-28-08-038537,3317962,33,
3323035,3323066,2022-07-26_19-28-13-278766,3323069,31,
3328150,3328205,2022-07-26_19-28-18-553354,3328208,55,
3333378,3333494,2022-07-26_19-28-23-978194,3338476,116,
3338490,3338516,2022-07-26_19-28-29-124745,3338519,26,
3343585,3343610,2022-07-26_19-28-34-349082,3343614,25,
3348718,3348781,2022-07-26_19-28-39-648155,3348785,63,
3353855,3353879,2022-07-26_19-28-44-870681,3353882,24,
3358960,3358987,2022-07-26_19-28-50-107242,3358990,27,
3364127,3364154,2022-07-26_19-28-55-405265,3364157,27,
3369237,3369264,2022-07-26_19-29-00-645980,3369267,27,
3374342,3374373,2022-07-26_19-29-05-883442,3374377,31,
3379451,3379478,2022-07-26_19-29-11-116231,3379481,27,
3384559,3384584,2022-07-26_19-29-16-353606,3384587,25,
3389667,
3394777,3394801,2022-07-26_19-29-26-825603,3394805,24,
3399904,3399954,2022-07-26_19-29-32-079412,3399958,50,
3405008,3405032,2022-07-26_19-29-37-312880,3405036,24,
3410118,3410142,2022-07-26_19-29-42-549446,3410146,24,
3415236,3415304,2022-07-26_19-29-47-839524,3415307,68,
3420359,3420406,2022-07-26_19-29-53-071391,3420409,47,
3425465,3425500,2022-07-26_19-29-58-293024,3425503,35,
3430571,3430596,2022-07-26_19-30-03-517032,3430599,25,
3435712,3435780,2022-07-26_19-30-08-832056,3435783,68,
3440841,3440875,2022-07-26_19-30-14-061708,3440878,34,
3445991,3446065,2022-07-26_19-30-19-378027,3446068,74,
3451098,3451166,2022-07-26_19-30-24-610725,3451170,68,
3456207,3456254,2022-07-26_19-30-29-830682,3456257,47,
3461326,3461349,2022-07-26_19-30-35-052957,3461352,23,
3466433,3466455,2022-07-26_19-30-40-285969,3466459,22,
3471602,3471626,2022-07-26_19-30-45-587188,3471629,24,
3476712,3476840,2022-07-26_19-30-50-926129,3481816,128,
3481829,3481852,2022-07-26_19-30-56-073094,3481855,23,
3486925,3492055,2022-07-26_19-31-01-296849,3492074,5130,
3492094,3492118,2022-07-26_19-31-06-596743,3492122,24,
3497170,3497212,2022-07-26_19-31-11-819280,3497215,42,
3502287,3502311,2022-07-26_19-31-17-046882,3502316,24,
3507444,3507475,2022-07-26_19-31-22-341375,3507478,31,
3512610,3512633,2022-07-26_19-31-27-628807,3512637,23,
3517717,3517742,2022-07-26_19-31-32-869548,3517746,25,
3522836,3527937,2022-07-26_19-31-38-337342,3527943,5101,
3527944,3527976,2022-07-26_19-31-43-356469,3527986,32,
3533044,3533072,2022-07-26_19-31-48-578479,3533078,28,
3538164,3538273,2022-07-26_19-31-53-916366,3543271,109,
3543294,3543359,2022-07-26_19-31-59-126941,3543362,65,
3548379,3548404,2022-07-26_19-32-04-300877,3548407,25,
3553510,3558645,2022-07-26_19-32-09-772687,3558648,5135,
3558649,3558675,2022-07-26_19-32-14-825703,3558678,26,
3563813,3563848,2022-07-26_19-32-20-119408,3563854,35,
3568967,3569031,2022-07-26_19-32-25-445581,3569035,64,
3574073,3574112,2022-07-26_19-32-30-658322,3574118,39,
3579182,3579209,2022-07-26_19-32-35-881486,3579212,27,
3584338,3584410,2022-07-26_19-32-41-213446,3584414,72,
3589444,3589495,2022-07-26_19-32-46-427261,3589500,51,
3594551,3594598,2022-07-26_19-32-51-654134,3594604,47,
3599696,3599719,2022-07-26_19-32-56-909337,3599724,23,
3604848,3604875,2022-07-26_19-33-02-192029,3604878,27,
3609985,3610010,2022-07-26_19-33-07-457530,3610013,25,
3615158,3620307,2022-07-26_19-33-12-918084,3620313,5149,
3620313,3620376,2022-07-26_19-33-18-081321,3620380,63,
3625422,3625491,2022-07-26_19-33-23-321639,3625495,69,
3630521,3630609,2022-07-26_19-33-28-568513,3630611,88,
3635686,3635737,2022-07-26_19-33-33-831712,3635740,51,
3640813,3640879,2022-07-26_19-33-39-102907,3640882,66,
3645931,3645963,2022-07-26_19-33-44-311504,3645966,32,
3651039,3651064,2022-07-26_19-33-49-547273,3651067,25,
3656147,3656239,2022-07-26_19-33-54-841162,3656246,92,
3661292,3661321,2022-07-26_19-34-00-061377,3661324,29,
3666393,3671527,2022-07-26_19-34-05-378617,3671544,5134,
3671567,3676634,2022-07-26_19-34-10-606788,3676651,5067,
3676672,3676700,2022-07-26_19-34-15-829001,3676703,28,
3681739,3681793,2022-07-26_19-34-21-052160,3681796,54,
3686847,3686873,2022-07-26_19-34-26-259255,3686876,26,
3691954,3692018,2022-07-26_19-34-31-508571,3692024,64,
3697072,3697096,2022-07-26_19-34-36-740679,3697099,24,
3702186,3702275,2022-07-26_19-34-42-043758,3702278,89,
3707309,3707339,2022-07-26_19-34-47-234288,3707342,30,
3712417,3712443,2022-07-26_19-34-52-473151,3712447,26,
3717535,3717564,2022-07-26_19-34-57-716800,3717569,29,
3722636,3722662,2022-07-26_19-35-02-943934,3722666,26,
3727742,3727768,2022-07-26_19-35-08-181937,3727772,26,
3732855,3732878,2022-07-26_19-35-13-420779,3732881,23,
3737990,3738034,2022-07-26_19-35-18-702342,3738038,44,
3743098,3743129,2022-07-26_19-35-23-924789,3743133,31,
3748200,3753308,2022-07-26_19-35-29-249624,3753325,5108,
3753348,3753419,2022-07-26_19-35-34-476099,3753422,71,
3758424,3758450,2022-07-26_19-35-39-633267,3758454,26,
3763538,3763605,2022-07-26_19-35-44-919514,3763610,67,
3768650,3768695,2022-07-26_19-35-50-143108,3768699,45,
3773758,3773786,2022-07-26_19-35-55-358722,3773789,28,
3778895,3784053,2022-07-26_19-36-00-626622,3784064,5158,
3784079,3784106,2022-07-26_19-36-05-938765,3784109,27,
3789157,3789182,2022-07-26_19-36-11-143654,3789186,25,
3794266,3794300,2022-07-26_19-36-16-389005,3794303,34,
3799373,3799400,2022-07-26_19-36-21-618370,3799403,27,
3804480,3804507,2022-07-26_19-36-26-854489,3804511,27,