RD,TS_received,TS_sent,AK,RoundTrip,
147321,147345,2022-07-26_13-06-33-534372,147348,24,
152443,152467,2022-07-26_13-06-38-785757,152470,24,
157613,157641,2022-07-26_13-06-44-087733,157645,28,
162729,162752,2022-07-26_13-06-49-329629,162755,23,
167836,167860,2022-07-26_13-06-54-568494,167863,24,
172954,172978,2022-07-26_13-06-59-816584,172981,24,
178064,178092,2022-07-26_13-07-05-053542,178095,28,
183231,183255,2022-07-26_13-07-10-350763,183259,24,
188367,188416,2022-07-26_13-07-15-632687,188419,49,
193476,193500,2022-07-26_13-07-20-857996,193503,24,
198583,198607,2022-07-26_13-07-26-093673,198610,24,
203690,203713,2022-07-26_13-07-31-329049,203717,23,
208818,208842,2022-07-26_13-07-36-590043,208845,24,
213927,213951,2022-07-26_13-07-41-828033,213954,24,
219079,219102,2022-07-26_13-07-47-106625,219106,23,
224213,224239,2022-07-26_13-07-52-372379,224241,26,
229357,229380,2022-07-26_13-07-57-646598,229383,23,
234501,234529,2022-07-26_13-08-02-922643,234532,28,
239719,239744,2022-07-26_13-08-08-271724,239747,25,
244860,244885,2022-07-26_13-08-13-543399,244889,25,
249996,250028,2022-07-26_13-08-18-811355,250031,32,
255130,255154,2022-07-26_13-08-24-077358,255157,24,
260260,260285,2022-07-26_13-08-29-334214,260288,25,
265412,265435,2022-07-26_13-08-34-612992,265439,23,
270550,270578,2022-07-26_13-08-39-882863,270581,28,
275705,275729,2022-07-26_13-08-45-169040,275733,24,
280833,280861,2022-07-26_13-08-50-432782,280864,28,
285976,286001,2022-07-26_13-08-55-699798,286004,25,
291228,291251,2022-07-26_13-09-01-085046,291255,23,
296343,296375,2022-07-26_13-09-06-335834,296378,32,
301457,301495,2022-07-26_13-09-11-573050,301501,38,
306550,306601,2022-07-26_13-09-16-808698,306604,51,
311662,311693,2022-07-26_13-09-22-041487,311696,31,
316770,316823,2022-07-26_13-09-27-298355,316827,53,
321921,321948,2022-07-26_13-09-32-555558,321951,27,
327073,327099,2022-07-26_13-09-37-838422,327103,26,
332221,332248,2022-07-26_13-09-43-120528,332251,27,
337376,337400,2022-07-26_13-09-48-404779,337403,24,
342523,342547,2022-07-26_13-09-53-679340,342550,24,
347631,347654,2022-07-26_13-09-58-914541,347657,23,
352773,352802,2022-07-26_13-10-04-190258,352806,29,
357907,357931,2022-07-26_13-10-09-450797,357935,24,
363041,363068,2022-07-26_13-10-14-716715,363071,27,
368185,368210,2022-07-26_13-10-19-989835,368213,25,
373341,373364,2022-07-26_13-10-25-278806,373367,23,
378478,378506,2022-07-26_13-10-30-546947,378509,28,
383584,383609,2022-07-26_13-10-35-778762,383612,25,
388724,388749,2022-07-26_13-10-41-045476,388752,25,
393863,393887,2022-07-26_13-10-46-312720,393890,24,
399015,399061,2022-07-26_13-10-51-619515,399064,46,
404131,404154,2022-07-26_13-10-56-840499,404158,23,
409243,409361,2022-07-26_13-11-02-176668,414370,118,
414393,414430,2022-07-26_13-11-07-372897,414433,37,
419484,419510,2022-07-26_13-11-12-585370,419513,26,
424597,424627,2022-07-26_13-11-17-828264,424630,30,
429704,429727,2022-07-26_13-11-23-059831,429730,23,
434807,434838,2022-07-26_13-11-28-300116,434841,31,
439922,440003,2022-07-26_13-11-33-590789,440006,81,
445050,445097,2022-07-26_13-11-38-816884,445101,47,
450158,450187,2022-07-26_13-11-44-035590,450191,29,
455262,455388,2022-07-26_13-11-49-362797,460368,126,
460390,460486,2022-07-26_13-11-54-588089,460489,96,
465488,465594,2022-07-26_13-11-59-821487,465597,106,
470596,470661,2022-07-26_13-12-05-028780,470666,65,
475733,480833,2022-07-26_13-12-10-457893,480837,5100,
480837,480860,2022-07-26_13-12-15-487864,480865,23,
485976,486037,2022-07-26_13-12-20-793625,486040,61,
491132,491226,2022-07-26_13-12-26-118468,491236,94,
496289,496319,2022-07-26_13-12-31-338570,496323,30,
501396,501423,2022-07-26_13-12-36-573666,501426,27,
506483,506507,2022-07-26_13-12-41-789377,506510,24,
511603,511627,2022-07-26_13-12-47-040911,511631,24,
516713,516738,2022-07-26_13-12-52-280378,516742,25,
521822,521887,2022-07-26_13-12-57-559906,521891,65,
526956,526978,2022-07-26_13-13-02-784396,526982,22,
532056,532080,2022-07-26_13-13-08-015402,532083,24,
537209,537263,2022-07-26_13-13-13-331656,537266,54,
542321,542357,2022-07-26_13-13-18-554306,542360,36,
547427,547459,2022-07-26_13-13-23-780919,547465,32,
552532,552577,2022-07-26_13-13-29-035671,552580,45,
557643,557731,2022-07-26_13-13-34-318170,557735,88,
562776,562831,2022-07-26_13-13-39-547863,562837,55,
567906,567929,2022-07-26_13-13-44-781671,567932,23,
573014,573038,2022-07-26_13-13-50-017299,573042,24,
578126,578149,2022-07-26_13-13-55-258244,578152,23,
583234,583258,2022-07-26_13-14-00-495522,583261,24,
588402,588427,2022-07-26_13-14-05-794413,588430,25,
593550,593577,2022-07-26_13-14-11-075190,593580,27,
598721,598747,2022-07-26_13-14-16-373891,598750,26,
603835,603864,2022-07-26_13-14-21-614873,603868,29,
608936,608971,2022-07-26_13-14-26-848142,608974,35,
614044,614093,2022-07-26_13-14-32-090270,614096,49,
619152,619198,2022-07-26_13-14-37-337613,619201,46,
624299,624326,2022-07-26_13-14-42-594287,624329,27,
629445,629468,2022-07-26_13-14-47-872205,629472,23,
634608,634645,2022-07-26_13-14-53-179862,634648,37,
639742,639772,2022-07-26_13-14-58-430084,639776,30,
644871,644900,2022-07-26_13-15-03-692209,644904,29,
649981,650006,2022-07-26_13-15-08-925354,650010,25,
655122,655146,2022-07-26_13-15-14-193911,655149,24,
660280,660307,2022-07-26_13-15-19-488113,660310,27,
665404,665434,2022-07-26_13-15-24-738590,665438,30,
670511,670537,2022-07-26_13-15-29-973606,670540,26,
675668,675693,2022-07-26_13-15-35-260524,675696,25,
680806,680830,2022-07-26_13-15-40-528599,680833,24,
685945,685975,2022-07-26_13-15-45-803499,685978,30,
691075,691099,2022-07-26_13-15-51-059613,691102,24,
696183,696207,2022-07-26_13-15-56-293530,696210,24,
701345,701370,2022-07-26_13-16-01-588279,701373,25,
706452,706479,2022-07-26_13-16-06-826690,706482,27,
711562,711592,2022-07-26_13-16-12-066228,711595,30,
716704,716743,2022-07-26_13-16-17-339859,716747,39,
721836,721861,2022-07-26_13-16-22-598963,721864,25,
726985,727024,2022-07-26_13-16-27-887196,727027,39,
732092,732118,2022-07-26_13-16-33-115760,732121,26,
737201,737226,2022-07-26_13-16-38-350698,737229,25,
742355,742379,2022-07-26_13-16-43-634858,742382,24,
747462,747489,2022-07-26_13-16-48-872974,747492,27,
752625,752651,2022-07-26_13-16-54-166220,752654,26,
757732,757762,2022-07-26_13-16-59-399751,757765,30,
762924,
768030,768055,2022-07-26_13-17-09-955130,768058,25,
773190,773215,2022-07-26_13-17-15-248889,773218,25,
778300,778330,2022-07-26_13-17-20-489577,778333,30,
783423,783451,2022-07-26_13-17-25-741644,783455,28,
788564,788587,2022-07-26_13-17-31-010370,788591,23,
793700,793725,2022-07-26_13-17-36-275233,793728,25,
798816,798841,2022-07-26_13-17-41-521040,798844,25,
803977,804002,2022-07-26_13-17-46-812889,804006,25,
809129,809164,2022-07-26_13-17-52-105683,809168,35,
814268,814319,2022-07-26_13-17-57-367858,814323,51,
819398,819422,2022-07-26_13-18-02-623050,819425,24,
824541,824564,2022-07-26_13-18-07-896470,824568,23,
829669,829692,2022-07-26_13-18-13-151861,829696,23,
834778,834802,2022-07-26_13-18-18-392866,834806,24,
839884,839909,2022-07-26_13-18-23-629106,839912,25,
845041,845066,2022-07-26_13-18-28-916463,845069,25,
850148,850178,2022-07-26_13-18-34-156433,850181,30,
855256,855280,2022-07-26_13-18-39-386370,855283,24,
860413,860438,2022-07-26_13-18-44-675257,860441,25,
865520,865548,2022-07-26_13-18-49-912065,865551,28,
870629,870653,2022-07-26_13-18-55-148097,870657,24,
875737,875761,2022-07-26_13-19-00-383031,875764,24,
880883,880907,2022-07-26_13-19-05-660417,880910,24,
885991,886027,2022-07-26_13-19-10-899005,886030,36,
891099,891134,2022-07-26_13-19-16-134829,891137,35,
896208,896230,2022-07-26_13-19-21-370980,896234,22,
901314,901337,2022-07-26_13-19-26-608399,901340,23,
906462,906486,2022-07-26_13-19-31-883824,906490,24,
911570,911597,2022-07-26_13-19-37-122177,911601,27,
916695,916720,2022-07-26_13-19-42-375733,916723,25,
921806,921829,2022-07-26_13-19-47-613404,921832,23,
926953,926981,2022-07-26_13-19-52-899272,926985,28,
932060,932084,2022-07-26_13-19-58-128224,932088,24,
937168,937191,2022-07-26_13-20-03-365145,937195,23,
942288,942312,2022-07-26_13-20-08-617987,942315,24,
947396,947419,2022-07-26_13-20-13-851574,947422,23,
952504,957649,2022-07-26_13-20-19-093335,957659,5145,
957677,957747,2022-07-26_13-20-24-439433,957753,70,
962772,962822,2022-07-26_13-20-29-646490,962825,50,
967883,967934,2022-07-26_13-20-34-882629,967938,51,
972988,973046,2022-07-26_13-20-40-107242,973051,58,
978097,978121,2022-07-26_13-20-45-332730,978124,24,
983197,988341,2022-07-26_13-20-50-562442,988359,5144,
988380,988406,2022-07-26_13-20-55-875151,988409,26,
993475,993504,2022-07-26_13-21-01-098811,993507,29,
998579,998602,2022-07-26_13-21-06-330365,998605,23,
1003696,1003792,2022-07-26_13-21-11-642341,1003796,96,
1008806,1008880,2022-07-26_13-21-16-864906,1008883,74,
1013914,1013980,2022-07-26_13-21-22-092042,1013987,66,
1019028,1019083,2022-07-26_13-21-27-318914,1019088,55,
1024155,1029289,2022-07-26_13-21-32-739075,1029292,5134,
1029292,1029318,2022-07-26_13-21-37-815791,1029321,26,
1034433,1034460,2022-07-26_13-21-43-094032,1034463,27,
1039571,
1044675,1049797,2022-07-26_13-21-53-880327,1049804,5122,
1049804,1049830,2022-07-26_13-21-58-849031,1049833,26,
1054908,1054948,2022-07-26_13-22-04-099041,1054953,40,
1060016,1060077,2022-07-26_13-22-09-346558,1060080,61,
1065124,1065178,2022-07-26_13-22-14-581043,1065182,54,
1070258,1075357,2022-07-26_13-22-19-857160,1075371,5099,
1075392,1075509,2022-07-26_13-22-25-172067,1080468,117,
1080483,1080531,2022-07-26_13-22-30-315406,1080534,48,
1085561,
1090696,1090750,2022-07-26_13-22-40-798462,1090753,54,
1095858,1095888,2022-07-26_13-22-46-074903,1095892,30,
1101008,1106105,2022-07-26_13-22-51-409485,1106115,5097,
1106130,1106184,2022-07-26_13-22-56-612709,1111205,54,
1111205,1111229,2022-07-26_13-23-01-803461,1111232,24,
1116375,1116401,2022-07-26_13-23-07-106053,1116404,26,
1121520,1121546,2022-07-26_13-23-12-379890,1121550,26,
1126646,1126673,2022-07-26_13-23-17-633694,1126676,27,
1131762,1131786,2022-07-26_13-23-22-878683,1131789,24,
1136906,1136930,2022-07-26_13-23-28-155084,1136934,24,
1142080,1142104,2022-07-26_13-23-33-456403,1142107,24,
1147203,1147305,2022-07-26_13-23-38-788065,1147308,102,
1152314,1152339,2022-07-26_13-23-43-948527,1152342,25,
1157512,1157599,2022-07-26_13-23-49-343009,1157603,87,
1162651,
1167776,
1172890,1172985,2022-07-26_13-24-05-114581,1172989,95,
1178062,1178087,2022-07-26_13-24-10-347448,1178090,25,
1183184,1183258,2022-07-26_13-24-15-646154,1183261,74,
1188278,1188303,2022-07-26_13-24-20-817533,1188306,25,
1193442,1193466,2022-07-26_13-24-26-112486,1193470,24,
1198590,1198645,2022-07-26_13-24-31-422910,1198648,55,
1203696,1203759,2022-07-26_13-24-36-655775,1203765,63,
1208806,1208866,2022-07-26_13-24-41-903098,1208870,60,
1213910,1219033,2022-07-26_13-24-47-202942,1219042,5123,
1219058,1219098,2022-07-26_13-24-52-386463,1219101,40,
1224214,1224239,2022-07-26_13-24-57-659442,1224242,25,
1229398,1229451,2022-07-26_13-25-02-976944,1229454,53,
1234506,1234544,2022-07-26_13-25-08-213565,1234547,38,
1239611,1239714,2022-07-26_13-25-13-521547,1244754,103,
1244776,1244800,2022-07-26_13-25-18-742734,1244803,24,
1249891,1249915,2022-07-26_13-25-23-986141,1249918,24,
1255030,1255078,2022-07-26_13-25-29-278216,1255081,48,
1260128,1260163,2022-07-26_13-25-34-490178,1260167,35,
1265243,1265283,2022-07-26_13-25-39-735367,1265288,40,
1270363,1270387,2022-07-26_13-25-44-975647,1270390,24,
1275533,1280625,2022-07-26_13-25-50-479759,1280629,5092,
1280629,1280655,2022-07-26_13-25-55-499726,1280659,26,
1285761,1285784,2022-07-26_13-26-00-758281,1285788,23,
1290880,1290904,2022-07-26_13-26-06-008664,1290907,24,
1295988,1296016,2022-07-26_13-26-11-249256,1296019,28,
1301106,1301136,2022-07-26_13-26-16-495785,1301141,30,
1306205,1311343,2022-07-26_13-26-22-537806,1311349,5138,
1311349,1311424,2022-07-26_13-26-27-039741,1311429,75,
1316479,1316503,2022-07-26_13-26-32-252806,1316506,24,
1321599,1321699,2022-07-26_13-26-37-579388,1321702,100,
1326713,1326829,2022-07-26_13-26-42-837819,1331825,116,
1331848,1331899,2022-07-26_13-26-48-034649,1331905,51,
1336953,1336989,2022-07-26_13-26-53-252416,1336995,36,
1342055,1342103,2022-07-26_13-26-58-497394,1342107,48,
1347166,1352311,2022-07-26_13-27-03-904612,1352318,5145,
1352318,1352365,2022-07-26_13-27-09-017091,1352369,47,
1357423,1357478,2022-07-26_13-27-14-251763,1357485,55,
1362536,1362575,2022-07-26_13-27-19-475115,1362583,39,
1367642,1372798,2022-07-26_13-27-24-905937,1372805,5156,
1372805,1372857,2022-07-26_13-27-30-018724,1372863,52,
1377913,1377943,2022-07-26_13-27-35-237219,1377946,30,
1383015,1383056,2022-07-26_13-27-40-469635,1383061,41,
1388123,1388223,2022-07-26_13-27-45-777787,1388228,100,
1393275,1393318,2022-07-26_13-27-51-007174,1393321,43,
1398393,1398418,2022-07-26_13-27-56-235047,1398421,25,
1403497,1403525,2022-07-26_13-28-01-471743,1403528,28,
1408664,1408715,2022-07-26_13-28-06-769048,1408719,51,
1413802,1413828,2022-07-26_13-28-12-034499,1413831,26,
1418915,1419008,2022-07-26_13-28-17-340651,1419012,93,
1424055,1429153,2022-07-26_13-28-22-749574,1429157,5098,
1429157,1429184,2022-07-26_13-28-27-775730,1429187,27,
1434268,1434374,2022-07-26_13-28-33-094866,1439365,106,
1439383,1439480,2022-07-26_13-28-38-331558,1439484,97,
1444488,1444552,2022-07-26_13-28-43-531879,1444555,64,
1449644,1449748,2022-07-26_13-28-48-857408,1454751,104,
1454774,1454849,2022-07-26_13-28-54-087398,1454855,75,
1459862,1459963,2022-07-26_13-28-59-327810,1459966,101,
1465004,1465040,2022-07-26_13-29-04-531288,1465044,36,
1470109,1470162,2022-07-26_13-29-09-780266,1470165,53,
1475213,1475325,2022-07-26_13-29-15-071085,1480371,112,
1480393,1480433,2022-07-26_13-29-20-303573,1480440,40,
1485487,1485515,2022-07-26_13-29-25-525171,1485518,28,
1490585,1490611,2022-07-26_13-29-30-747264,1490614,26,
1495747,1495810,2022-07-26_13-29-36-073113,1495813,63,
1500844,1500903,2022-07-26_13-29-41-292653,1500908,59,
1505967,1505998,2022-07-26_13-29-46-519580,1506001,31,
1511081,1511104,2022-07-26_13-29-51-756191,1511107,23,
1516181,1516205,2022-07-26_13-29-56-984646,1516208,24,
1521345,1521377,2022-07-26_13-30-02-288112,1521381,32,
1526447,1526474,2022-07-26_13-30-07-516827,1526477,27,
1531551,1531576,2022-07-26_13-30-12-743843,1531579,25,
1536666,1536770,2022-07-26_13-30-18-069940,1536773,104,
1541755,1541838,2022-07-26_13-30-23-268551,1541841,83,
1546915,1546945,2022-07-26_13-30-28-502616,1546948,30,
1552077,1552155,2022-07-26_13-30-33-833382,1552161,78,
1557182,1557251,2022-07-26_13-30-39-067923,1557254,69,
1562291,1567393,2022-07-26_13-30-44-438933,1567398,5102,
1567398,1567432,2022-07-26_13-30-49-499368,1567436,34,
1572501,1572526,2022-07-26_13-30-54-725407,1572529,25,
1577606,1577700,2022-07-26_13-31-00-032513,1577703,94,
1582767,1582799,2022-07-26_13-31-05-259886,1582802,32,
1587866,1587893,2022-07-26_13-31-10-478427,1587896,27,
1593017,1593101,2022-07-26_13-31-15-815168,1593107,84,
1598156,1598183,2022-07-26_13-31-21-033448,1598187,27,
1603259,1603389,2022-07-26_13-31-26-357706,1608405,130,
1608430,1608486,2022-07-26_13-31-31-584778,1608491,56,
1613510,1613540,2022-07-26_13-31-36-769033,1613543,30,
1618667,1618694,2022-07-26_13-31-42-055948,1618697,27,
1623833,1623862,2022-07-26_13-31-47-355805,1623866,29,
1628935,1628957,2022-07-26_13-31-52-579967,1628960,22,
1634102,1634141,2022-07-26_13-31-57-889563,1634144,39,
1639211,1644366,2022-07-26_13-32-03-325904,1644369,5155,
1644369,1644393,2022-07-26_13-32-08-405301,1644396,24,
1649501,1649536,2022-07-26_13-32-13-677979,1649540,35,
1654613,1654734,2022-07-26_13-32-18-998476,1659716,121,
1659739,1659802,2022-07-26_13-32-24-202590,1659805,63,
1664821,1664844,2022-07-26_13-32-29-373680,1664847,23,
1669930,1669986,2022-07-26_13-32-34-646727,1669990,56,
1675040,1675064,2022-07-26_13-32-39-850063,1675067,24,
1680145,1680170,2022-07-26_13-32-45-087220,1680173,25,
1685259,1685284,2022-07-26_13-32-50-327682,1685287,25,
1690407,1690435,2022-07-26_13-32-55-610085,1690438,28,
1695514,1695540,2022-07-26_13-33-00-843418,1695543,26,
1700676,1700744,2022-07-26_13-33-06-183676,1700747,68,
1705778,1705847,2022-07-26_13-33-11-413207,1705850,69,
1710898,1710953,2022-07-26_13-33-16-640247,1710959,55,
1716038,1716065,2022-07-26_13-33-21-888013,1716068,27,
1721175,1721226,2022-07-26_13-33-27-182844,1721230,51,
1726288,1726321,2022-07-26_13-33-32-400273,1726324,33,
1731398,1731421,2022-07-26_13-33-37-635723,1731426,23,
1736503,1736528,2022-07-26_13-33-42-871385,1736531,25,
1741661,1741716,2022-07-26_13-33-48-182985,1741722,55,
1746776,1746805,2022-07-26_13-33-53-403270,1746808,29,
1751875,1751906,2022-07-26_13-33-58-633946,1751910,31,
1756983,1757007,2022-07-26_13-34-03-869635,1757010,24,
1762091,1762137,2022-07-26_13-34-09-121297,1762141,46,
1767199,1767228,2022-07-26_13-34-14-341441,1767231,29,
1772307,1772338,2022-07-26_13-34-19-586008,1772342,31,
1777414,1777442,2022-07-26_13-34-24-814478,1777445,28,
1782525,1782549,2022-07-26_13-34-30-053328,1782552,24,
1787631,1787659,2022-07-26_13-34-35-291636,1787662,28,
1792743,1792767,2022-07-26_13-34-40-530296,1792770,24,
1797851,1797874,2022-07-26_13-34-45-764042,1797877,23,
1803008,1803034,2022-07-26_13-34-51-049555,1803038,26,
1808130,1808153,2022-07-26_13-34-56-303458,1808157,23,
1813238,1813261,2022-07-26_13-35-01-537531,1813264,23,
1818347,1818372,2022-07-26_13-35-06-774588,1818375,25,
1823459,1823483,2022-07-26_13-35-12-017090,1823486,24,
1828566,1828618,2022-07-26_13-35-17-275956,1828622,52,
1833674,1833700,2022-07-26_13-35-22-492561,1833703,26,
1838821,1843942,2022-07-26_13-35-27-817905,1843946,5121,
1843946,
1849054,1849082,2022-07-26_13-35-38-262202,1849086,28,
1854190,1854216,2022-07-26_13-35-43-527336,1854219,26,
1859338,1859362,2022-07-26_13-35-48-801653,1859365,24,
1864472,1864497,2022-07-26_13-35-54-064706,1864500,25,
1869632,1869660,2022-07-26_13-35-59-363188,1869663,28,
1874746,1874769,2022-07-26_13-36-04-603081,1874773,23,
1879848,1879875,2022-07-26_13-36-09-832844,1879878,27,
1884999,1885024,2022-07-26_13-36-15-110745,1885028,25,
1890107,1890133,2022-07-26_13-36-20-348917,1890136,26,
1895253,1895279,2022-07-26_13-36-25-624370,1895282,26,
1900404,1900425,2022-07-26_13-36-30-902552,1900429,21,
1905540,1905564,2022-07-26_13-36-36-172343,1905567,24,
1910647,1910675,2022-07-26_13-36-41-408417,1910678,28,
1915791,1915834,2022-07-26_13-36-46-699741,1915837,43,
1920949,1920974,2022-07-26_13-36-51-967981,1920978,25,
1926123,1926148,2022-07-26_13-36-57-271042,1926151,25,
1931271,1931297,2022-07-26_13-37-02-549964,1931300,26,
1936417,1936461,2022-07-26_13-37-07-825755,1936464,44,
1941557,1941594,2022-07-26_13-37-13-107713,1941597,37,
1946684,1946720,2022-07-26_13-37-18-359593,1946723,36,
1951790,1951819,2022-07-26_13-37-23-591626,1951823,29,
1956943,1956969,2022-07-26_13-37-28-874173,1956972,26,
1962083,1962107,2022-07-26_13-37-34-143966,1962111,24,
1967225,1967248,2022-07-26_13-37-39-414421,1967251,23,
1972372,1972397,2022-07-26_13-37-44-695804,1972400,25,
1977538,1977577,2022-07-26_13-37-49-992981,1977580,39,
1982663,1982715,2022-07-26_13-37-55-268188,1982719,52,
1987769,1987820,2022-07-26_13-38-00-502057,1987826,51,
1992873,1992899,2022-07-26_13-38-05-713453,1992902,26,
1997980,1998005,2022-07-26_13-38-10-948489,1998008,25,
2003107,2003182,2022-07-26_13-38-16-257792,2003186,75,
2008216,2008282,2022-07-26_13-38-21-482663,2008286,66,
2013307,2013389,2022-07-26_13-38-26-723956,2013392,82,
2018429,2018453,2022-07-26_13-38-31-916617,2018456,24,
2023541,2023566,2022-07-26_13-38-37-157185,2023569,25,
2028649,
2033743,2033768,2022-07-26_13-38-47-620488,2033771,25,
2038878,2038903,2022-07-26_13-38-52-881624,2038907,25,
2044028,2044054,2022-07-26_13-38-58-161609,2044058,26,
2049148,2049170,2022-07-26_13-39-03-410154,2049174,22,
2054261,2054285,2022-07-26_13-39-08-655092,2054289,24,
2059370,2059394,2022-07-26_13-39-13-893179,2059398,24,
2064477,2064503,2022-07-26_13-39-19-128619,2064506,26,
2069585,2069609,2022-07-26_13-39-24-370880,2069612,24,
2074693,2074716,2022-07-26_13-39-29-605694,2074720,23,
2079846,2079870,2022-07-26_13-39-34-890416,2079873,24,
2084975,2085016,2022-07-26_13-39-40-165685,2085019,41,
2090083,2090106,2022-07-26_13-39-45-390657,2090111,23,
2095200,2095224,2022-07-26_13-39-50-636849,2095227,24,
2100309,2100336,2022-07-26_13-39-55-873596,2100340,27,
2105416,2105440,2022-07-26_13-40-01-109050,2105444,24,
2110524,2110548,2022-07-26_13-40-06-347760,2110551,24,
2115631,2115661,2022-07-26_13-40-11-584378,2115665,30,
2120739,2120764,2022-07-26_13-40-16-825873,2120767,25,
2125888,2125911,2022-07-26_13-40-22-103633,2125915,23,
2130995,2131023,2022-07-26_13-40-27-342625,2131026,28,
2136147,2136188,2022-07-26_13-40-32-636717,2136192,41,
2141255,2141280,2022-07-26_13-40-37-858591,2141283,25,
2146362,2146392,2022-07-26_13-40-43-101822,2146395,30,
2151473,2151498,2022-07-26_13-40-48-338863,2151502,25,
2156579,2156607,2022-07-26_13-40-53-574557,2156610,28,
2161689,2161714,2022-07-26_13-40-58-811459,2161718,25,
2166819,2166842,2022-07-26_13-41-04-066601,2166845,23,
2171979,2172002,2022-07-26_13-41-09-355988,2172006,23,
2177086,2177122,2022-07-26_13-41-14-607471,2177126,36,
2182245,2182273,2022-07-26_13-41-19-892187,2182276,28,
2187351,2187376,2022-07-26_13-41-25-123855,2187379,25,
2192459,2192482,2022-07-26_13-41-30-356076,2192486,23,
2197568,2197592,2022-07-26_13-41-35-598701,2197595,24,
2202674,2202703,2022-07-26_13-41-40-836802,2202707,29,
2207782,2207807,2022-07-26_13-41-46-071058,2207812,25,
2212891,2212916,2022-07-26_13-41-51-308468,2212919,25,
2218059,2218082,2022-07-26_13-41-56-608504,2218085,23,
2223218,2223244,2022-07-26_13-42-01-899661,2223247,26,
2228326,2228349,2022-07-26_13-42-07-137218,2228353,23,
2233433,2233457,2022-07-26_13-42-12-375321,2233461,24,
2238541,2238566,2022-07-26_13-42-17-612434,2238569,25,
2243650,2243676,2022-07-26_13-42-22-851708,2243681,26,
2248799,2248828,2022-07-26_13-42-28-132164,2248832,29,
2253910,2253934,2022-07-26_13-42-33-371104,2253937,24,
2259017,2259068,2022-07-26_13-42-38-611584,2259071,51,
2264124,2264150,2022-07-26_13-42-43-845364,2264154,26,
2269276,2269338,2022-07-26_13-42-49-140035,2269342,62,
2274383,2274408,2022-07-26_13-42-54-360676,2274413,25,
2279511,2279542,2022-07-26_13-42-59-629102,2279546,31,
2284637,2284661,2022-07-26_13-43-04-875916,2284665,24,
2289746,2289771,2022-07-26_13-43-10-114109,2289774,25,
2294890,2294918,2022-07-26_13-43-15-388226,2294922,28,
2300018,2300044,2022-07-26_13-43-20-646801,2300047,26,
2305162,2305190,2022-07-26_13-43-25-921978,2305194,28,
2310299,2310343,2022-07-26_13-43-31-202754,2310346,44,
2315458,2315482,2022-07-26_13-43-36-477003,2315486,24,
2320565,2320590,2022-07-26_13-43-41-714871,2320594,25,
2325672,2325698,2022-07-26_13-43-46-950205,2325701,26,
2330831,2330858,2022-07-26_13-43-52-237571,2330862,27,
2335960,2335986,2022-07-26_13-43-57-496569,2335989,26,
2341067,2341093,2022-07-26_13-44-02-733423,2341097,26,
2346232,2346258,2022-07-26_13-44-08-024799,2346261,26,
2351389,2351415,2022-07-26_13-44-13-315389,2351419,26,
2356497,2356521,2022-07-26_13-44-18-549013,2356524,24,
2361640,2361663,2022-07-26_13-44-23-821669,2361666,23,
2366780,2366804,2022-07-26_13-44-29-092997,2366808,24,
2371922,2371948,2022-07-26_13-44-34-362309,2371951,26,
2377055,2377080,2022-07-26_13-44-39-624817,2377084,25,
2382183,2382206,2022-07-26_13-44-44-881727,2382209,23,
2387332,2387361,2022-07-26_13-44-50-157797,2387364,29,
2392440,2392464,2022-07-26_13-44-55-394584,2392467,24,
2397579,2397606,2022-07-26_13-45-00-665719,2397609,27,
2402709,2402733,2022-07-26_13-45-05-923464,2402736,24,
2407853,2407900,2022-07-26_13-45-11-197343,2407904,47,
2412996,2413019,2022-07-26_13-45-16-467267,2413022,23,
2418160,2418188,2022-07-26_13-45-21-766726,2418191,28,
2423275,2423299,2022-07-26_13-45-27-010298,2423302,24,
2428410,2428445,2022-07-26_13-45-32-282359,2428448,35,
2433518,2433541,2022-07-26_13-45-37-511511,2433545,23,
2438663,2438689,2022-07-26_13-45-42-790438,2438693,26,
2443813,2443840,2022-07-26_13-45-48-066753,2443843,27,
2448961,2448990,2022-07-26_13-45-53-350300,2448993,29,
2454120,2454144,2022-07-26_13-45-58-636227,2454147,24,
2459320,2459350,2022-07-26_13-46-03-969300,2459354,30,
2464460,2464486,2022-07-26_13-46-09-233502,2464489,26,
2469599,2469623,2022-07-26_13-46-14-502627,2469626,24,
2474741,2474766,2022-07-26_13-46-19-776150,2474770,25,
2479846,2479916,2022-07-26_13-46-25-049031,2479919,70,
2484964,2484988,2022-07-26_13-46-30-255199,2484992,24,
2490072,2490101,2022-07-26_13-46-35-497082,2490104,29,
2495222,2495252,2022-07-26_13-46-40-772175,2495255,30,
2500329,2500353,2022-07-26_13-46-46-007893,2500356,24,
2505487,2505513,2022-07-26_13-46-51-293472,2505516,26,
2510595,2510620,2022-07-26_13-46-56-529770,2510623,25,
2515772,2515796,2022-07-26_13-47-01-839078,2515799,24,
2520884,2520908,2022-07-26_13-47-07-079618,2520912,24,
2526024,2526085,2022-07-26_13-47-12-382447,2526090,61,
2531161,2531185,2022-07-26_13-47-17-616291,2531189,24,
2536268,2536323,2022-07-26_13-47-22-876311,2536327,55,
2541379,2541403,2022-07-26_13-47-28-094088,2541406,24,
2546487,2546511,2022-07-26_13-47-33-328918,2546514,24,
2551594,2551624,2022-07-26_13-47-38-565047,2551627,30,
2556709,2556733,2022-07-26_13-47-43-810380,2556736,24,
2561815,2561891,2022-07-26_13-47-49-089602,2561894,76,
2566955,2566981,2022-07-26_13-47-54-313804,2566984,26,
2572091,2572120,2022-07-26_13-47-59-580648,2572123,29,
2577333,2577379,2022-07-26_13-48-04-967366,2577383,46,
2582438,2582465,2022-07-26_13-48-10-185489,2582468,27,
2587542,2587660,2022-07-26_13-48-15-516410,2592648,118,
2592661,2592687,2022-07-26_13-48-20-665215,2592690,26,
2597759,2597784,2022-07-26_13-48-25-893645,2597787,25,
2602873,2607971,2022-07-26_13-48-31-302481,2607975,5098,
2607975,2608016,2022-07-26_13-48-36-369421,2608019,41,
2613091,2613130,2022-07-26_13-48-41-622297,2613133,39,
2618201,2618228,2022-07-26_13-48-46-854148,2618231,27,
2623304,2623337,2022-07-26_13-48-52-080482,2623342,33,
2628407,2633527,2022-07-26_13-48-57-500693,2633533,5120,
2633533,2633603,2022-07-26_13-49-02-613784,2633606,70,
2638644,2638693,2022-07-26_13-49-07-837105,2638696,49,
2643771,2643794,2022-07-26_13-49-13-066325,2643798,23,
2648872,2648897,2022-07-26_13-49-18-294513,2648900,25,
2653977,2654006,2022-07-26_13-49-23-534809,2654009,29,
2659140,2659184,2022-07-26_13-49-28-835761,2659189,44,
2664245,2664272,2022-07-26_13-49-34-055164,2664275,27,
2669357,2669389,2022-07-26_13-49-39-303833,2669392,32,
2674467,2674557,2022-07-26_13-49-44-597942,2674560,90,
2679590,2679675,2022-07-26_13-49-49-852165,2679679,85,
2684736,2689889,2022-07-26_13-49-55-067031,2689905,5153,
2689924,2689955,2022-07-26_13-50-00-380475,2689958,31,
2695012,2695036,2022-07-26_13-50-05-598914,2695040,24,
2700167,2700191,2022-07-26_13-50-10-882388,2700195,24,
2705324,2705422,2022-07-26_13-50-16-240399,2705425,98,
2710424,2710448,2022-07-26_13-50-21-397338,2710452,24,
2715541,2715605,2022-07-26_13-50-26-685608,2715608,64,
2720628,2720654,2022-07-26_13-50-31-858165,2720658,26,
2725798,2725823,2022-07-26_13-50-37-159516,2725826,25,
2730915,2730994,2022-07-26_13-50-42-459989,2730997,79,
2736026,2736052,2022-07-26_13-50-47-646709,2736055,26,
2741120,2746253,2022-07-26_13-50-52-938994,2746262,5133,
2746277,2746306,2022-07-26_13-50-58-158793,2746309,29,
2751385,2751464,2022-07-26_13-51-03-438745,2751467,79,
2756528,2761631,2022-07-26_13-51-08-866997,2761634,5103,
2761635,2766738,2022-07-26_13-51-13-928808,2766748,5103,
2766771,2766848,2022-07-26_13-51-19-217211,2766851,77,
2771896,2771933,2022-07-26_13-51-24-436668,2771937,37,
2777011,2777036,2022-07-26_13-51-29-668716,2777039,25,
2782173,2782228,2022-07-26_13-51-34-988110,2782231,55,
2787280,2787332,2022-07-26_13-51-40-216731,2787337,52,
2792387,2792429,2022-07-26_13-51-45-439356,2792436,42,
2797498,2797532,2022-07-26_13-51-50-669548,2797535,34,
2802607,2802635,2022-07-26_13-51-55-901479,2802639,28,
2807751,2807774,2022-07-26_13-52-01-173653,2807777,23,
2812860,2812900,2022-07-26_13-52-06-428742,2812903,40,
2817992,2818040,2022-07-26_13-52-11-671831,2818043,48,
2823112,2823136,2022-07-26_13-52-16-920864,2823139,24,
2828229,2828286,2022-07-26_13-52-22-194555,2828289,57,
2833328,2833351,2022-07-26_13-52-27-394624,2833355,23,
2838443,2838468,2022-07-26_13-52-32-638473,2838471,25,
2843552,2843578,2022-07-26_13-52-37-876851,2843581,26,
2848665,2848688,2022-07-26_13-52-43-120231,2848692,23,
2853809,2853862,2022-07-26_13-52-48-416664,2853867,53,
2858955,2858979,2022-07-26_13-52-53-671674,2858982,24,
2864065,2864166,2022-07-26_13-52-58-992025,2864170,101,
2869165,2869224,2022-07-26_13-53-04-175725,2869227,59,
2874277,2874324,2022-07-26_13-53-09-386461,2874328,47,
2879426,2884568,2022-07-26_13-53-14-761086,2884585,5142,
2884600,2884627,2022-07-26_13-53-19-961518,2884630,27,
2889683,2894844,2022-07-26_13-53-25-276541,2894855,5161,
2894868,2894901,2022-07-26_13-53-30-499344,2894904,33,
2899965,2899995,2022-07-26_13-53-35-721627,2899999,30,
2905074,2905100,2022-07-26_13-53-40-955318,2905103,26,
2910216,2910239,2022-07-26_13-53-46-226036,2910242,23,
2915333,2915421,2022-07-26_13-53-51-539465,2915425,88,
2920441,2920470,2022-07-26_13-53-56-715946,2920475,29,
2925544,2925570,2022-07-26_13-54-01-943907,2925573,26,
2930720,2930746,2022-07-26_13-54-07-251226,2930749,26,
2935887,2935957,2022-07-26_13-54-12-588397,2935960,70,
2940989,2941014,2022-07-26_13-54-17-776886,2941018,25,
2946161,2946225,2022-07-26_13-54-23-121706,2946228,64,
2951258,2951282,2022-07-26_13-54-28-304874,2951286,24,
2956375,2961507,2022-07-26_13-54-33-710809,2961510,5132,
2961510,2961536,2022-07-26_13-54-38-817514,2961539,26,
2966627,2966711,2022-07-26_13-54-44-121432,2966715,84,
2971729,2971753,2022-07-26_13-54-49-293849,2971757,24,
2976843,2976904,2022-07-26_13-54-54-569743,2976907,61,
2981953,2982020,2022-07-26_13-54-59-804342,2982026,67,
2987063,2987094,2022-07-26_13-55-05-018448,2987096,31,
2992166,2992195,2022-07-26_13-55-10-245196,2992202,29,
2997330,3002457,2022-07-26_13-55-15-556373,3002467,5127,
3002480,3002506,2022-07-26_13-55-20-818276,3002510,26,
3007570,3007593,2022-07-26_13-55-26-037494,3007597,23,
3012677,3012702,2022-07-26_13-55-31-272341,3012705,25,
3017785,3017808,2022-07-26_13-55-36-505080,3017811,23,
3022896,3022919,2022-07-26_13-55-41-748984,3022922,23,
3028060,3028087,2022-07-26_13-55-47-044285,3028090,27,
3033169,3033199,2022-07-26_13-55-52-285964,3033202,30,
3038276,3038302,2022-07-26_13-55-57-517128,3038305,26,
3043387,3043416,2022-07-26_13-56-02-759328,3043419,29,
3048501,3048525,2022-07-26_13-56-07-998217,3048528,24,
3053608,3053646,2022-07-26_13-56-13-236763,3053649,38,
3058757,3058781,2022-07-26_13-56-18-515548,3058784,24,
3063898,3063928,2022-07-26_13-56-23-790362,3063931,30,
3069041,3069067,2022-07-26_13-56-29-062316,3069069,26,
3074188,3074246,2022-07-26_13-56-34-346674,3074249,58,
3079344,3079371,2022-07-26_13-56-39-619750,3079374,27,
3084453,3084476,2022-07-26_13-56-44-861204,3084479,23,
3089576,3089601,2022-07-26_13-56-50-113570,3089604,25,
3094685,3094709,2022-07-26_13-56-55-348699,3094712,24,
3099828,3099860,2022-07-26_13-57-00-627822,3099863,32,
3104947,3104979,2022-07-26_13-57-05-878355,3104982,32,
3110069,3110092,2022-07-26_13-57-11-119423,3110095,23,
3115178,3115205,2022-07-26_13-57-16-358662,3115208,27,
3120290,3120315,2022-07-26_13-57-21-602138,3120318,25,
3125411,3125435,2022-07-26_13-57-26-848691,3125439,24,
3130557,3130584,2022-07-26_13-57-32-125468,3130587,27,
3135691,3135716,2022-07-26_13-57-37-389397,3135720,25,
3140830,3140855,2022-07-26_13-57-42-662195,3140859,25,
3145937,3145961,2022-07-26_13-57-47-894880,3145965,24,
3151055,3151081,2022-07-26_13-57-53-140177,3151085,26,
3156218,3156245,2022-07-26_13-57-58-435720,3156248,27,
3161382,3161405,2022-07-26_13-58-03-727513,3161408,23,
3166553,3166579,2022-07-26_13-58-09-030894,3166582,26,
3171689,3171716,2022-07-26_13-58-14-299008,3171720,27,
3176836,3176860,2022-07-26_13-58-19-570083,3176865,24,
3181965,3181992,2022-07-26_13-58-24-831346,3181995,27,
3187077,3187101,2022-07-26_13-58-30-067955,3187105,24,
3192225,3192252,2022-07-26_13-58-35-346042,3192255,27,
3197364,3197398,2022-07-26_13-58-40-625222,3197402,34,
3202483,3202507,2022-07-26_13-58-45-863714,3202511,24,
3207615,3207640,2022-07-26_13-58-51-124014,3207644,25,
3212748,3212774,2022-07-26_13-58-56-389763,3212777,26,
3217908,3217932,2022-07-26_13-59-01-675261,3217935,24,
3223057,3223080,2022-07-26_13-59-06-954569,3223085,23,
3228175,3228214,2022-07-26_13-59-12-213329,3228217,39,
3233286,3233316,2022-07-26_13-59-17-441012,3233322,30,
3238391,3238417,2022-07-26_13-59-22-670943,3238420,26,
3243516,3243540,2022-07-26_13-59-27-926558,3243543,24,
3248668,3248693,2022-07-26_13-59-33-210111,3248695,25,
3253780,3253811,2022-07-26_13-59-38-455582,3253814,31,
3258928,3258976,2022-07-26_13-59-43-750626,3258980,48,
3264035,3264076,2022-07-26_13-59-48-973031,3264079,41,
3269143,3269172,2022-07-26_13-59-54-198664,3269175,29,
3274253,3274353,2022-07-26_13-59-59-512978,3274356,100,
3279364,3279453,2022-07-26_14-00-04-742804,3279457,89,
3284526,3284548,2022-07-26_14-00-09-971258,3284552,22,
3289631,3289661,2022-07-26_14-00-15-201264,3289665,30,
3294745,3294771,2022-07-26_14-00-20-443584,3294774,26,
3299858,3299882,2022-07-26_14-00-25-688032,3299885,24,
3304966,3304990,2022-07-26_14-00-30-922700,3304993,24,
3310074,3310109,2022-07-26_14-00-36-162170,3310112,35,
3315181,3315213,2022-07-26_14-00-41-393175,3315217,32,
3320290,3320315,2022-07-26_14-00-46-628968,3320318,25,
3325404,3325429,2022-07-26_14-00-51-871567,3325434,25,
3330511,3330538,2022-07-26_14-00-57-106057,3330541,27,
3335618,3335642,2022-07-26_14-01-02-341134,3335645,24,
3340777,3340802,2022-07-26_14-01-07-628969,3340805,25,
3345948,3345983,2022-07-26_14-01-12-938182,3345986,35,
3351055,3351100,2022-07-26_14-01-18-174106,3351103,45,
3356163,3356220,2022-07-26_14-01-23-436866,3356223,57,
3361273,3361307,2022-07-26_14-01-28-658661,3361310,34,
3366382,3366408,2022-07-26_14-01-33-883292,3366411,26,
3371489,3371528,2022-07-26_14-01-39-122758,3371532,39,
3376598,3376627,2022-07-26_14-01-44-366123,3376631,29,
3381706,3381734,2022-07-26_14-01-49-594629,3381737,28,
3386815,3386840,2022-07-26_14-01-54-837008,3386843,25,
3391969,3391993,2022-07-26_14-02-00-118689,3391996,24,
3397118,3397142,2022-07-26_14-02-05-399621,3397146,24,
3402222,3402249,2022-07-26_14-02-10-634629,3402253,27,
3407332,3407356,2022-07-26_14-02-15-869558,3407359,24,
3412437,3412460,2022-07-26_14-02-21-101155,3412463,23,
3417591,3417618,2022-07-26_14-02-26-390045,3417623,27,
3422696,3422722,2022-07-26_14-02-31-620618,3422725,26,
3427854,3427880,2022-07-26_14-02-36-909483,3427884,26,
3432960,3432989,2022-07-26_14-02-42-141394,3432992,29,
3438106,3438130,2022-07-26_14-02-47-418345,3438133,24,
3443226,3443251,2022-07-26_14-02-52-667003,3443254,25,
3448332,3448364,2022-07-26_14-02-57-908060,3448367,32,
3453440,3453464,2022-07-26_14-03-03-140647,3453468,24,
3458548,3458579,2022-07-26_14-03-08-381973,3458583,31,
3463656,3463682,2022-07-26_14-03-13-611360,3463685,26,
3468764,3468788,2022-07-26_14-03-18-851313,3468793,24,
3473933,3473981,2022-07-26_14-03-24-173044,3473985,48,
3479099,3479123,2022-07-26_14-03-29-447678,3479127,24,
3484244,3484275,2022-07-26_14-03-34-719653,3484278,31,
3489352,3489378,2022-07-26_14-03-39-958712,3489381,26,
3494460,3494483,2022-07-26_14-03-45-196437,3494486,23,
3499630,3499704,2022-07-26_14-03-50-541457,3499710,74,
3504738,3504805,2022-07-26_14-03-55-767328,3504810,67,
3509881,3509984,2022-07-26_14-04-01-082883,3509989,103,
3515012,3515036,2022-07-26_14-04-06-267037,3515039,24,
3520149,3520174,2022-07-26_14-04-11-537139,3520177,25,
3525251,3525274,2022-07-26_14-04-16-765201,3525278,23,
3530389,3530449,2022-07-26_14-04-22-071217,3530454,60,
3535518,3535544,2022-07-26_14-04-27-294464,3535548,26,
3540630,3545743,2022-07-26_14-04-32-717359,3545746,5113,
3545747,3545771,2022-07-26_14-04-37-782655,3545775,24,
3550885,3550909,2022-07-26_14-04-43-046251,3550914,24,
3556053,3556122,2022-07-26_14-04-48-395801,3556126,69,
3561186,3561214,2022-07-26_14-04-53-614474,3561217,28,
3566319,3566344,2022-07-26_14-04-58-871544,3566347,25,
3571471,3571496,2022-07-26_14-05-04-152500,3571499,25,
3576643,3576708,2022-07-26_14-05-09-492408,3576712,65,
3581765,3581797,2022-07-26_14-05-14-704335,3581800,32,
3586864,3586893,2022-07-26_14-05-19-933881,3586896,29,
3591971,3591995,2022-07-26_14-05-25-168983,3591999,24,
3597066,3597101,2022-07-26_14-05-30-391209,3597107,35,
3602219,3602244,2022-07-26_14-05-35-675022,3602247,25,
3607385,3607471,2022-07-26_14-05-41-031582,3607477,86,
3612492,3612558,2022-07-26_14-05-46-243628,3612562,66,
3617578,3622728,2022-07-26_14-05-54-565866,3622740,5150,
3622753,3622787,2022-07-26_14-05-56-731940,3622791,34,
3627842,3632976,2022-07-26_14-06-01-946528,3632986,5134,
3632999,3633023,2022-07-26_14-06-07-229389,3633027,24,
3638088,3638127,2022-07-26_14-06-12-463189,3638131,39,
3643196,3643228,2022-07-26_14-06-17-689605,3643231,32,
3648299,3653446,2022-07-26_14-06-23-117796,3653449,5147,
3653450,3653472,2022-07-26_14-06-28-196281,3653475,22,
3658567,3658610,2022-07-26_14-06-33-460219,3658617,43,
3663667,3663704,2022-07-26_14-06-38-671303,3663707,37,
3668783,3668810,2022-07-26_14-06-43-919030,3668814,27,
3673954,3673978,2022-07-26_14-06-49-220240,3673981,24,
3679070,3684223,2022-07-26_14-06-54-464108,3684240,5153,
3684264,3684289,2022-07-26_14-06-59-791047,3684292,25,
3689347,3689371,2022-07-26_14-07-05-003631,3689374,24,
3694456,3694567,2022-07-26_14-07-10-325479,3699558,111,
3699581,3699645,2022-07-26_14-07-15-537606,3699649,64,
3704678,3704752,2022-07-26_14-07-20-769094,3704760,74,
3709785,3709856,2022-07-26_14-07-26-005360,3709860,71,
3714898,3714922,2022-07-26_14-07-31-199813,3714926,24,
3720007,3720035,2022-07-26_14-07-36-436603,3720041,28,
3725112,3725138,2022-07-26_14-07-41-673198,3725143,26,
3730282,3735428,2022-07-26_14-07-47-138429,3735434,5146,
3735435,3735540,2022-07-26_14-07-52-307675,3735543,105,
3740534,3740557,2022-07-26_14-07-57-483926,3740561,23,
3745649,3750746,2022-07-26_14-08-02-737799,3750756,5097,
3750769,3750802,2022-07-26_14-08-07-980418,3750807,33,
3755857,3755882,2022-07-26_14-08-13-196117,3755885,25,
3760968,3761001,2022-07-26_14-08-18-440043,3761004,33,
3766076,3766106,2022-07-26_14-08-23-679653,3766109,30,
3771183,3771208,2022-07-26_14-08-28-911164,3771211,25,
3776293,3776322,2022-07-26_14-08-34-148385,3776325,29,
3781400,3781427,2022-07-26_14-08-39-384084,3781430,27,
3786507,3786533,2022-07-26_14-08-44-619335,3786536,26,
3791624,3791654,2022-07-26_14-08-49-866771,3791657,30,
3796724,3796749,2022-07-26_14-08-55-089873,3796753,25,
3801833,3801858,2022-07-26_14-09-00-327698,3801861,25,
3806972,3806995,2022-07-26_14-09-05-594601,3806999,23,
3812089,3812117,2022-07-26_14-09-10-842872,3812121,28,
3817204,3817228,2022-07-26_14-09-16-084868,3817231,24,
3822318,3822347,2022-07-26_14-09-21-334509,3822350,29,
3827426,3827502,2022-07-26_14-09-26-616557,3827512,76,
3832559,3832591,2022-07-26_14-09-31-832570,3832595,32,
3837662,3842777,2022-07-26_14-09-37-270438,3842781,5115,
3842781,3842807,2022-07-26_14-09-42-311462,3842811,26,
3847888,3847912,2022-07-26_14-09-47-544650,3847915,24,
3853057,3853083,2022-07-26_14-09-52-843279,3853087,26,
3858163,3858189,2022-07-26_14-09-58-078791,3858192,26,
3863311,3863335,2022-07-26_14-10-03-357522,3863338,24,
3868419,3868454,2022-07-26_14-10-08-592354,3868458,35,
3873526,3873557,2022-07-26_14-10-13-831487,3873560,31,
3878634,3878715,2022-07-26_14-10-19-088014,3878718,81,
3883747,3883773,2022-07-26_14-10-24-312239,3883776,26,
3888855,3893958,2022-07-26_14-10-29-571734,3893968,5103,
3893983,3894007,2022-07-26_14-10-34-803465,3894010,24,
3899079,3899126,2022-07-26_14-10-40-047441,3899129,47,
3904188,3904310,2022-07-26_14-10-45-364641,3909305,122,
3909323,3909406,2022-07-26_14-10-50-585892,3909411,83,
3914470,3914499,2022-07-26_14-10-55-809729,3914502,29,
3919642,3919694,2022-07-26_14-11-01-135967,3919699,52,
3924752,3924777,2022-07-26_14-11-06-350468,3924781,25,
3929854,3929976,2022-07-26_14-11-11-680049,3934963,122,
3934986,3935058,2022-07-26_14-11-16-894378,3935061,72,
3940099,3940124,2022-07-26_14-11-22-086494,3940127,25,
3945208,3945243,2022-07-26_14-11-27-336600,3945246,35,
3950324,3950349,2022-07-26_14-11-32-571133,3950353,25,
3955432,3955460,2022-07-26_14-11-37-807538,3955464,28,
3960552,3960583,2022-07-26_14-11-43-057936,3960585,31,
3966562,
3976545,
3985158,