RD,TS_received,TS_sent,AK,RoundTrip,
236596,236639,2022-08-16_10-23-47-826031,236642,43,
241696,241736,2022-08-16_10-23-53-048879,241740,40,
246810,246859,2022-08-16_10-23-58-291293,246863,49,
251914,251939,2022-08-16_10-24-03-503380,251942,25,
257044,257069,2022-08-16_10-24-08-762297,257072,25,
262161,262240,2022-08-16_10-24-14-043300,262245,79,
267287,267320,2022-08-16_10-24-19-263079,267323,33,
272393,272424,2022-08-16_10-24-24-492531,272429,31,
277495,277519,2022-08-16_10-24-29-720417,277523,24,
282611,282708,2022-08-16_10-24-35-033348,282711,97,
287720,287800,2022-08-16_10-24-40-255794,287803,80,
292866,292890,2022-08-16_10-24-45-472049,292893,24,
297971,297994,2022-08-16_10-24-50-702597,297999,23,
303078,303103,2022-08-16_10-24-55-936013,303106,25,
308230,308302,2022-08-16_10-25-01-252626,308307,72,
313339,313385,2022-08-16_10-25-06-472815,313391,46,
318445,318471,2022-08-16_10-25-11-687370,318474,26,
323569,323594,2022-08-16_10-25-16-936758,323597,25,
328710,328734,2022-08-16_10-25-22-209441,328738,24,
333826,333868,2022-08-16_10-25-27-463264,333874,42,
338935,338963,2022-08-16_10-25-32-688235,338966,28,
344038,344064,2022-08-16_10-25-37-916605,344067,26,
349206,349256,2022-08-16_10-25-43-234580,349261,50,
354313,354370,2022-08-16_10-25-48-466051,354376,57,
359419,359448,2022-08-16_10-25-53-679740,359452,29,
364535,364635,2022-08-16_10-25-58-996089,364638,100,
369642,369666,2022-08-16_10-26-04-150726,369669,24,
374779,374819,2022-08-16_10-26-09-423957,374822,40,
379936,379971,2022-08-16_10-26-14-700056,379975,35,
385066,385094,2022-08-16_10-26-19-961873,385098,28,
390185,390217,2022-08-16_10-26-25-210753,390220,32,
395300,395323,2022-08-16_10-26-30-442530,395327,23,
400454,400478,2022-08-16_10-26-35-725808,400481,24,
405575,405608,2022-08-16_10-26-40-982044,405611,33,
410680,410709,2022-08-16_10-26-46-204337,410712,29,
415788,415818,2022-08-16_10-26-51-436041,415824,30,
420898,420923,2022-08-16_10-26-56-677388,420926,25,
426005,
431134,
436242,436292,2022-08-16_10-27-12-424362,436295,50,
441367,441390,2022-08-16_10-27-17-649618,441393,23,
446474,446497,2022-08-16_10-27-22-883762,446500,23,
451635,451688,2022-08-16_10-27-28-190017,451691,53,
456742,456779,2022-08-16_10-27-33-415739,456782,37,
461882,461905,2022-08-16_10-27-38-671780,461909,23,
467027,467078,2022-08-16_10-27-43-966837,467084,51,
472156,472183,2022-08-16_10-27-49-199395,472186,27,
477449,477562,2022-08-16_10-27-54-715209,482580,113,
482600,482657,2022-08-16_10-27-59-937618,482660,57,
487744,487768,2022-08-16_10-28-05-178453,487771,24,
492888,492945,2022-08-16_10-28-10-480930,492949,57,
497998,498046,2022-08-16_10-28-15-707582,498051,48,
503096,503125,2022-08-16_10-28-20-914787,503129,29,
508262,508285,2022-08-16_10-28-26-208744,508289,23,
513371,513394,2022-08-16_10-28-31-444866,513397,23,
518489,518513,2022-08-16_10-28-36-693881,518516,24,
523591,528694,2022-08-16_10-28-42-025017,528704,5103,
528717,528742,2022-08-16_10-28-47-176315,528746,25,
533845,533873,2022-08-16_10-28-52-431193,533877,28,
538965,539007,2022-08-16_10-28-57-691984,539013,42,
544068,544097,2022-08-16_10-29-02-911044,544100,29,
549178,549202,2022-08-16_10-29-08-145010,549206,24,
554288,554312,2022-08-16_10-29-13-383336,554316,24,
559393,559418,2022-08-16_10-29-18-618476,559421,25,
564511,564564,2022-08-16_10-29-23-894368,564567,53,
569619,569684,2022-08-16_10-29-29-132369,569690,65,
574742,574770,2022-08-16_10-29-34-352625,574774,28,
579843,579872,2022-08-16_10-29-39-579245,579875,29,
584952,584975,2022-08-16_10-29-44-812287,584978,23,
590125,590155,2022-08-16_10-29-50-116501,590159,30,
595231,595257,2022-08-16_10-29-55-345007,595261,26,
600372,600397,2022-08-16_10-30-00-613647,600400,25,
605494,605520,2022-08-16_10-30-05-859995,605524,26,
610600,610651,2022-08-16_10-30-11-114982,610654,51,
615711,615739,2022-08-16_10-30-16-331213,615742,28,
620817,620841,2022-08-16_10-30-21-560620,620844,24,
625975,626001,2022-08-16_10-30-26-848482,626004,26,
631082,631105,2022-08-16_10-30-32-082286,631109,23,
636190,636234,2022-08-16_10-30-37-333403,636238,44,
641300,641324,2022-08-16_10-30-42-552179,641327,24,
646448,646473,2022-08-16_10-30-47-824580,646477,25,
651556,651581,2022-08-16_10-30-53-059406,651584,25,
656663,656686,2022-08-16_10-30-58-294940,656690,23,
661772,661796,2022-08-16_10-31-03-528995,661799,24,
666879,666906,2022-08-16_10-31-08-764543,666909,27,
672022,672045,2022-08-16_10-31-14-034349,672048,23,
677184,677208,2022-08-16_10-31-19-324602,677212,24,
682292,682317,2022-08-16_10-31-24-557190,682320,25,
687400,687427,2022-08-16_10-31-29-792871,687430,27,
692516,692539,2022-08-16_10-31-35-036112,692542,23,
697669,697698,2022-08-16_10-31-40-318042,697701,29,
702816,702842,2022-08-16_10-31-45-586220,702845,26,
707922,707948,2022-08-16_10-31-50-820186,707952,26,
713062,713085,2022-08-16_10-31-56-087846,713089,23,
718201,718225,2022-08-16_10-32-01-357298,718228,24,
723331,723354,2022-08-16_10-32-06-608490,723357,23,
728474,728497,2022-08-16_10-32-11-882656,728500,23,
733615,733640,2022-08-16_10-32-17-149983,733644,25,
738745,738769,2022-08-16_10-32-22-406749,738772,24,
743861,743884,2022-08-16_10-32-27-646546,743888,23,
749002,749026,2022-08-16_10-32-32-916380,749029,24,
754140,754165,2022-08-16_10-32-38-182870,754168,25,
759284,759312,2022-08-16_10-32-43-458442,759316,28,
764428,764453,2022-08-16_10-32-48-728211,764456,25,
769549,769580,2022-08-16_10-32-53-979282,769583,31,
774656,774684,2022-08-16_10-32-59-209019,774687,28,
779802,779827,2022-08-16_10-33-04-480430,779830,25,
784952,784977,2022-08-16_10-33-09-758512,784980,25,
790100,790123,2022-08-16_10-33-15-035683,790127,23,
795230,795253,2022-08-16_10-33-20-293276,795257,23,
800374,800399,2022-08-16_10-33-25-565069,800402,25,
805527,805556,2022-08-16_10-33-30-842255,805559,29,
810643,810668,2022-08-16_10-33-36-086281,810672,25,
815769,815794,2022-08-16_10-33-41-344508,815797,25,
820895,820923,2022-08-16_10-33-46-597246,820927,28,
826024,826048,2022-08-16_10-33-51-848872,826051,24,
831157,831183,2022-08-16_10-33-57-112358,831186,26,
836287,836312,2022-08-16_10-34-02-368961,836316,25,
841413,841438,2022-08-16_10-34-07-619369,841441,25,
846520,846545,2022-08-16_10-34-12-854315,846549,25,
851674,851698,2022-08-16_10-34-18-132416,851702,24,
856813,856836,2022-08-16_10-34-23-400006,856839,23,
861970,862004,2022-08-16_10-34-28-689919,862008,34,
867109,867134,2022-08-16_10-34-33-951727,867137,25,
872267,872292,2022-08-16_10-34-39-238930,872295,25,
877421,877450,2022-08-16_10-34-44-523529,877453,29,
882538,882564,2022-08-16_10-34-49-763986,882567,26,
887646,887672,2022-08-16_10-34-54-998955,887676,26,
892793,892845,2022-08-16_10-35-00-301945,892848,52,
897940,897965,2022-08-16_10-35-05-549536,897968,25,
903047,903071,2022-08-16_10-35-10-782527,903074,24,
908187,908211,2022-08-16_10-35-16-050724,908214,24,
913387,913412,2022-08-16_10-35-21-380069,913416,25,
918495,918520,2022-08-16_10-35-26-613207,918523,25,
923617,923642,2022-08-16_10-35-31-859378,923645,25,
928759,928783,2022-08-16_10-35-37-129200,928787,24,
933866,933890,2022-08-16_10-35-42-365659,933893,24,
938974,939000,2022-08-16_10-35-47-597944,939003,26,
944087,944109,2022-08-16_10-35-52-835337,944112,22,
949194,949218,2022-08-16_10-35-58-070772,949222,24,
954341,954366,2022-08-16_10-36-03-347938,954369,25,
959448,959474,2022-08-16_10-36-08-582595,959477,26,
964611,964647,2022-08-16_10-36-13-874224,964652,36,
969722,969751,2022-08-16_10-36-19-111249,969754,29,
974829,974853,2022-08-16_10-36-24-339917,974857,24,
979936,979960,2022-08-16_10-36-29-572985,979963,24,
985045,985072,2022-08-16_10-36-34-809249,985076,27,
990152,990178,2022-08-16_10-36-40-042686,990182,26,
995262,995285,2022-08-16_10-36-45-278158,995288,23,
1000369,1000393,2022-08-16_10-36-50-511349,1000396,24,
1005477,1005501,2022-08-16_10-36-55-747233,1005505,24,
1010586,1010610,2022-08-16_10-37-00-983240,1010613,24,
1015730,1015754,2022-08-16_10-37-06-252978,1015757,24,
1020854,1020877,2022-08-16_10-37-11-503610,1020881,23,
1025965,1025989,2022-08-16_10-37-16-744569,1025993,24,
1031123,1031149,2022-08-16_10-37-22-027473,1031152,26,
1036231,1036255,2022-08-16_10-37-27-261469,1036258,24,
1041339,1041364,2022-08-16_10-37-32-493921,1041369,25,
1046488,1046513,2022-08-16_10-37-37-774072,1046517,25,
1051595,1051623,2022-08-16_10-37-43-005780,1051627,28,
1056704,1056728,2022-08-16_10-37-48-242132,1056731,24,
1061812,1061835,2022-08-16_10-37-53-476251,1061839,23,
1066926,1066952,2022-08-16_10-37-58-720076,1066956,26,
1072033,1072084,2022-08-16_10-38-03-956727,1072087,51,
1077142,1077166,2022-08-16_10-38-09-187794,1077169,24,
1082289,1082312,2022-08-16_10-38-14-464689,1082316,23,
1087419,1087446,2022-08-16_10-38-19-725504,1087449,27,
1092520,1092544,2022-08-16_10-38-24-950933,1092547,24,
1097678,1097702,2022-08-16_10-38-30-234057,1097705,24,
1102817,1102840,2022-08-16_10-38-35-502297,1102851,23,
1107967,1107993,2022-08-16_10-38-40-779046,1107997,26,
1113095,1113124,2022-08-16_10-38-46-034937,1113128,29,
1118286,1118311,2022-08-16_10-38-51-352712,1118314,25,
1123445,1123468,2022-08-16_10-38-56-643101,1123472,23,
1128579,1128605,2022-08-16_10-39-01-904959,1128608,26,
1133712,1133736,2022-08-16_10-39-07-163343,1133739,24,
1138851,1138913,2022-08-16_10-39-12-456220,1138916,62,
1143993,1144019,2022-08-16_10-39-17-701433,1144024,26,
1149117,1149144,2022-08-16_10-39-22-948663,1149147,27,
1154254,1154279,2022-08-16_10-39-28-214585,1154283,25,
1159384,1159412,2022-08-16_10-39-33-469585,1159416,28,
1164546,1164570,2022-08-16_10-39-38-759896,1164573,24,
1169679,1169701,2022-08-16_10-39-44-017959,1169705,22,
1174826,1174850,2022-08-16_10-39-49-296674,1174853,24,
1179934,1179961,2022-08-16_10-39-54-534605,1179965,27,
1185057,1185081,2022-08-16_10-39-59-780758,1185084,24,
1190175,1190202,2022-08-16_10-40-05-025336,1190206,27,
1195321,1195345,2022-08-16_10-40-10-298352,1195348,24,
1200476,1200505,2022-08-16_10-40-15-581765,1200509,29,
1205617,1205642,2022-08-16_10-40-20-848043,1205645,25,
1210748,1210772,2022-08-16_10-40-26-108871,1210776,24,
1215892,1215917,2022-08-16_10-40-31-378795,1215920,25,
1221036,1221064,2022-08-16_10-40-36-651336,1221067,28,
1226177,1226200,2022-08-16_10-40-41-917871,1226203,23,
1231319,1231344,2022-08-16_10-40-47-190322,1231347,25,
1236464,1236494,2022-08-16_10-40-52-465717,1236497,30,
1241570,1246720,2022-08-16_10-40-57-779367,1246735,5150,
1246748,1246771,2022-08-16_10-41-03-000578,1246774,23,
1251832,1251860,2022-08-16_10-41-08-213829,1251863,28,
1256940,1262047,2022-08-16_10-41-13-547454,1262056,5107,
1262078,1262149,2022-08-16_10-41-18-755206,1262152,71,
1267180,1267246,2022-08-16_10-41-23-980077,1267249,66,
1272289,1272315,2022-08-16_10-41-29-172422,1272318,26,
1277447,1277473,2022-08-16_10-41-34-456228,1277475,26,
1282564,1282641,2022-08-16_10-41-39-754836,1282644,77,
1287669,1287744,2022-08-16_10-41-44-985224,1287747,75,
1292758,1292843,2022-08-16_10-41-50-208050,1292849,85,
1297917,1297941,2022-08-16_10-41-55-435280,1297945,24,
1303205,1303232,2022-08-16_10-42-00-857653,1303235,27,
1308354,1308429,2022-08-16_10-42-06-184139,1308433,75,
1313463,1313547,2022-08-16_10-42-11-430612,1313550,84,
1318600,1318624,2022-08-16_10-42-16-630437,1318627,24,
1323704,1323728,2022-08-16_10-42-21-860484,1323733,24,
1328828,1328853,2022-08-16_10-42-27-115433,1328857,25,
1333976,1334004,2022-08-16_10-42-32-389454,1334007,28,
1339201,1339225,2022-08-16_10-42-37-744876,1339228,24,
1344342,1344366,2022-08-16_10-42-43-012258,1344369,24,
1349461,1349515,2022-08-16_10-42-48-271566,1349520,54,
1354576,1354603,2022-08-16_10-42-53-504708,1354606,27,
1359686,1359714,2022-08-16_10-42-58-735946,1359717,28,
1364802,1364882,2022-08-16_10-43-04-036546,1364885,80,
1369911,1369981,2022-08-16_10-43-09-261215,1369984,70,
1375063,1375086,2022-08-16_10-43-14-496091,1375090,23,
1380170,1380269,2022-08-16_10-43-19-800776,1380273,99,
1385278,1385369,2022-08-16_10-43-25-029711,1385374,91,
1390424,1390450,2022-08-16_10-43-30-237673,1390454,26,
1395549,1395581,2022-08-16_10-43-35-491802,1395584,32,
1400714,1400738,2022-08-16_10-43-40-779124,1400741,24,
1405831,1405855,2022-08-16_10-43-46-025095,1405858,24,
1410936,1410959,2022-08-16_10-43-51-258245,1410962,23,
1416037,1416074,2022-08-16_10-43-56-487744,1416078,37,
1421133,1421157,2022-08-16_10-44-01-704306,1421161,24,
1426254,1426279,2022-08-16_10-44-06-955305,1426282,25,
1431371,1431423,2022-08-16_10-44-12-223718,1431427,52,
1436483,1441626,2022-08-16_10-44-17-499994,1441636,5143,
1441656,1441731,2022-08-16_10-44-22-784496,1441737,75,
1446774,1446828,2022-08-16_10-44-28-007981,1446834,54,
1451880,1451928,2022-08-16_10-44-33-228752,1451934,48,
1456989,1457019,2022-08-16_10-44-38-452076,1457023,30,
1462108,1462205,2022-08-16_10-44-43-768311,1462208,97,
1467278,1467306,2022-08-16_10-44-48-996430,1467309,28,
1472373,1472414,2022-08-16_10-44-54-224626,1472420,41,
1477503,1477603,2022-08-16_10-44-59-545861,1477609,100,
1482602,1482627,2022-08-16_10-45-04-697848,1482630,25,
1487759,1487792,2022-08-16_10-45-09-985132,1487795,33,
1492865,1492899,2022-08-16_10-45-15-215878,1492905,34,
1497990,1498098,2022-08-16_10-45-20-543375,1503148,108,
1503162,1503186,2022-08-16_10-45-25-765776,1503189,24,
1508299,1508329,2022-08-16_10-45-31-031859,1508333,30,
1513448,1513473,2022-08-16_10-45-36-306750,1513477,25,
1518551,1518579,2022-08-16_10-45-41-537696,1518583,28,
1523708,1523733,2022-08-16_10-45-46-822265,1523736,25,
1528832,1528870,2022-08-16_10-45-52-076634,1528873,38,
1533987,1534058,2022-08-16_10-45-57-396896,1534062,71,
1539090,1539153,2022-08-16_10-46-02-623391,1539157,63,
1544202,1544253,2022-08-16_10-46-07-848969,1544257,51,
1549311,1549355,2022-08-16_10-46-13-071005,1549361,44,
1554429,1554453,2022-08-16_10-46-18-299334,1554456,24,
1559532,1559555,2022-08-16_10-46-23-532675,1559559,23,
1564695,1564733,2022-08-16_10-46-28-834395,1564736,38,
1569801,1569836,2022-08-16_10-46-34-063597,1569839,35,
1574905,1574930,2022-08-16_10-46-39-285356,1574934,25,
1580011,1585114,2022-08-16_10-46-44-520572,1585126,5103,
1585150,1585227,2022-08-16_10-46-49-835248,1585232,77,
1590244,1590270,2022-08-16_10-46-55-003080,1590273,26,
1595392,1595417,2022-08-16_10-47-00-279794,1595420,25,
1600538,1600598,2022-08-16_10-47-05-594479,1600612,60,
1605645,1605709,2022-08-16_10-47-10-825137,1605714,64,
1610778,1610808,2022-08-16_10-47-16-054527,1610812,30,
1615883,1615909,2022-08-16_10-47-21-281800,1615912,26,
1621054,1621094,2022-08-16_10-47-26-595139,1621100,40,
1626176,1626201,2022-08-16_10-47-31-831885,1626204,25,
1631288,1631382,2022-08-16_10-47-37-134651,1631385,94,
1636400,1636478,2022-08-16_10-47-42-358716,1636482,78,
1641502,1641526,2022-08-16_10-47-47-534425,1641529,24,
1646611,1646638,2022-08-16_10-47-52-768940,1646641,27,
1651727,1651772,2022-08-16_10-47-58-032526,1651775,45,
1656818,1656860,2022-08-16_10-48-03-247738,1656863,42,
1661973,1661999,2022-08-16_10-48-08-512931,1662002,26,
1667090,1667172,2022-08-16_10-48-13-803050,1667177,82,
1672257,1672282,2022-08-16_10-48-19-049402,1672285,25,
1677431,1677457,2022-08-16_10-48-24-354257,1677460,26,
1682528,1682551,2022-08-16_10-48-29-575781,1682556,23,
1687636,1692778,2022-08-16_10-48-34-996341,1692783,5142,
1692783,1692807,2022-08-16_10-48-40-086432,1692811,24,
1697901,1697929,2022-08-16_10-48-45-329511,1697932,28,
1703008,1703033,2022-08-16_10-48-50-560238,1703036,25,
1708107,1708148,2022-08-16_10-48-55-792685,1708153,41,
1713246,1713331,2022-08-16_10-49-01-112917,1713337,85,
1718353,1718418,2022-08-16_10-49-06-330668,1718421,65,
1723462,1723537,2022-08-16_10-49-11-568234,1723541,75,
1728573,1728607,2022-08-16_10-49-16-771819,1728610,34,
1733691,1733717,2022-08-16_10-49-22-011061,1733720,26,
1738800,1738895,2022-08-16_10-49-27-316581,1738899,95,
1743909,1743933,2022-08-16_10-49-32-475789,1743936,24,
1749028,1749120,2022-08-16_10-49-37-787600,1749123,92,
1754144,1754199,2022-08-16_10-49-42-994453,1754204,55,
1759254,1759279,2022-08-16_10-49-48-199740,1759283,25,
1764413,1764480,2022-08-16_10-49-53-532116,1764483,67,
1769546,1769570,2022-08-16_10-49-58-749721,1769573,24,
1774660,1774684,2022-08-16_10-50-03-989564,1774687,24,
1779795,1779824,2022-08-16_10-50-09-250504,1779827,29,
1784903,1784927,2022-08-16_10-50-14-487350,1784931,24,
1790010,1790037,2022-08-16_10-50-19-720997,1790040,27,
1795119,1795145,2022-08-16_10-50-24-954583,1795148,26,
1800228,1800250,2022-08-16_10-50-30-187455,1800254,22,
1805378,1805444,2022-08-16_10-50-35-494138,1805448,66,
1810486,1810517,2022-08-16_10-50-40-704927,1810520,31,
1815595,1815619,2022-08-16_10-50-45-936220,1815623,24,
1820702,1820727,2022-08-16_10-50-51-172815,1820731,25,
1825810,1825835,2022-08-16_10-50-56-407141,1825838,25,
1830973,1830996,2022-08-16_10-51-01-699171,1831000,23,
1836081,1836106,2022-08-16_10-51-06-933455,1836110,25,
1841188,1841215,2022-08-16_10-51-12-167323,1841218,27,
1846297,1846323,2022-08-16_10-51-17-405583,1846327,26,
1851405,1851429,2022-08-16_10-51-22-635191,1851432,24,
1856561,1856609,2022-08-16_10-51-27-928051,1856612,48,
1861663,1861687,2022-08-16_10-51-33-147409,1861690,24,
1866817,1866841,2022-08-16_10-51-38-432323,1866845,24,
1871925,1871952,2022-08-16_10-51-43-666043,1871955,27,
1877033,1877059,2022-08-16_10-51-48-897176,1877063,26,
1882184,1882213,2022-08-16_10-51-54-176592,1882216,29,
1887292,1887317,2022-08-16_10-51-59-408844,1887320,25,
1892441,1892466,2022-08-16_10-52-04-686579,1892469,25,
1897548,1897574,2022-08-16_10-52-09-919875,1897578,26,
1902690,1902715,2022-08-16_10-52-15-189184,1902718,25,
1907818,1907845,2022-08-16_10-52-20-444565,1907849,27,
1912926,1912951,2022-08-16_10-52-25-679537,1912954,25,
1918043,1918072,2022-08-16_10-52-30-921875,1918075,29,
1923191,1923214,2022-08-16_10-52-36-200609,1923217,23,
1928319,1928348,2022-08-16_10-52-41-455819,1928351,29,
1933465,1933488,2022-08-16_10-52-46-725450,1933491,23,
1938581,1938605,2022-08-16_10-52-51-969149,1938609,24,
1943690,1943715,2022-08-16_10-52-57-210384,1943718,25,
1948797,1948825,2022-08-16_10-53-02-442900,1948828,28,
1953905,1953931,2022-08-16_10-53-07-674792,1953934,26,
1959078,1959102,2022-08-16_10-53-12-975859,1959105,24,
1964224,1964246,2022-08-16_10-53-18-251595,1964249,22,
1969332,1969355,2022-08-16_10-53-23-482154,1969358,23,
1974483,1974508,2022-08-16_10-53-28-762665,1974512,25,
1979591,1979614,2022-08-16_10-53-33-996010,1979617,23,
1984727,1984751,2022-08-16_10-53-39-262921,1984754,24,
1989874,1989899,2022-08-16_10-53-44-535776,1989903,25,
1995012,1995036,2022-08-16_10-53-49-799572,1995040,24,
2000142,2000166,2022-08-16_10-53-55-055745,2000169,24,
2005280,2005308,2022-08-16_10-54-00-325502,2005312,28,
2010428,2010513,2022-08-16_10-54-05-655200,2010519,85,
2015537,2015591,2022-08-16_10-54-10-861347,2015594,54,
2020644,2020694,2022-08-16_10-54-16-090288,2020698,50,
2025753,2025790,2022-08-16_10-54-21-310751,2025793,37,
2030853,2030880,2022-08-16_10-54-26-531299,2030884,27,
2036000,2036026,2022-08-16_10-54-31-803342,2036030,26,
2041135,2041160,2022-08-16_10-54-37-067179,2041164,25,
2046262,2046285,2022-08-16_10-54-42-315749,2046289,23,
2051405,2051433,2022-08-16_10-54-47-588882,2051436,28,
2056543,2056572,2022-08-16_10-54-52-855251,2056575,29,
2061688,2061713,2022-08-16_10-54-58-128633,2061716,25,
2066796,2066819,2022-08-16_10-55-03-358989,2066823,23,
2071932,2071956,2022-08-16_10-55-08-624732,2071959,24,
2077074,2077100,2022-08-16_10-55-13-892180,2077103,26,
2082185,2082213,2022-08-16_10-55-19-134210,2082216,28,
2087335,2087360,2022-08-16_10-55-24-405122,2087363,25,
2092456,2092479,2022-08-16_10-55-29-653539,2092483,23,
2097563,2097588,2022-08-16_10-55-34-889342,2097591,25,
2102703,2102726,2022-08-16_10-55-40-156252,2102730,23,
2107811,2107835,2022-08-16_10-55-45-389903,2107839,24,
2112920,2112945,2022-08-16_10-55-50-627939,2112948,25,
2118056,2118079,2022-08-16_10-55-55-890360,2118082,23,
2123214,2123238,2022-08-16_10-56-01-176652,2123241,24,
2128450,2128473,2022-08-16_10-56-06-540816,2128477,23,
2133568,2133597,2022-08-16_10-56-11-786187,2133600,29,
2138685,2138709,2022-08-16_10-56-17-031848,2138712,24,
2143793,2143818,2022-08-16_10-56-22-266426,2143821,25,
2148913,2148937,2022-08-16_10-56-27-514022,2148940,24,
2154020,2154044,2022-08-16_10-56-32-744625,2154047,24,
2159181,2159204,2022-08-16_10-56-38-035391,2159208,23,
2164288,2164313,2022-08-16_10-56-43-266855,2164316,25,
2169395,2169420,2022-08-16_10-56-48-499958,2169423,25,
2174504,2174553,2022-08-16_10-56-53-760218,2174556,49,
2179612,2179647,2022-08-16_10-56-58-981539,2179650,35,
2184741,2184766,2022-08-16_10-57-04-224780,2184770,25,
2189847,2189871,2022-08-16_10-57-09-459788,2189874,24,
2195009,2195034,2022-08-16_10-57-14-747991,2195037,25,
2200187,2200215,2022-08-16_10-57-20-058260,2200219,28,
2205294,2205318,2022-08-16_10-57-25-289094,2205321,24,
2210402,2210427,2022-08-16_10-57-30-523683,2210431,25,
2215511,2215546,2022-08-16_10-57-35-768354,2215550,35,
2220628,2220655,2022-08-16_10-57-41-003900,2220658,27,
2225736,2225761,2022-08-16_10-57-46-236876,2225764,25,
2231116,2231147,2022-08-16_10-57-51-758066,2231151,31,
2236274,2236299,2022-08-16_10-57-57-033787,2236303,25,
2241381,2241407,2022-08-16_10-58-02-270021,2241410,26,
2246529,2246553,2022-08-16_10-58-07-546008,2246556,24,
2251682,2251707,2022-08-16_10-58-12-826430,2251710,25,
2256836,2256868,2022-08-16_10-58-18-117079,2256872,32,
2261947,2261970,2022-08-16_10-58-23-347014,2261973,23,
2267101,2267126,2022-08-16_10-58-28-627579,2267129,25,
2272216,2272242,2022-08-16_10-58-33-870728,2272246,26,
2277323,2277348,2022-08-16_10-58-39-104166,2277352,25,
2282434,2282460,2022-08-16_10-58-44-345470,2282463,26,
2287540,2287565,2022-08-16_10-58-49-571957,2287568,25,
2292651,2292674,2022-08-16_10-58-54-806510,2292677,23,
2297791,2297815,2022-08-16_10-59-00-077519,2297818,24,
2302941,2302970,2022-08-16_10-59-05-357762,2302974,29,
2308064,2308089,2022-08-16_10-59-10-607306,2308092,25,
2313224,2313248,2022-08-16_10-59-15-893067,2313251,24,
2318330,2318356,2022-08-16_10-59-21-130982,2318359,26,
2323437,2323464,2022-08-16_10-59-26-363914,2323469,27,
2328575,2328601,2022-08-16_10-59-31-629462,2328604,26,
2333711,2333740,2022-08-16_10-59-36-892035,2333745,29,
2338842,2338866,2022-08-16_10-59-42-150498,2338869,24,
2343989,2344012,2022-08-16_10-59-47-423541,2344015,23,
2349146,2349171,2022-08-16_10-59-52-710220,2349175,25,
2354252,2354276,2022-08-16_10-59-57-941309,2354279,24,
2359389,2359413,2022-08-16_11-00-03-207297,2359416,24,
2364554,2364582,2022-08-16_11-00-08-503432,2364585,28,
2369669,2369698,2022-08-16_11-00-13-738167,2369701,29,
2374801,2374827,2022-08-16_11-00-19-004165,2374830,26,
2379950,2379976,2022-08-16_11-00-24-278383,2379980,26,
2385072,2385097,2022-08-16_11-00-29-527223,2385101,25,
2390207,2390231,2022-08-16_11-00-34-785850,2390234,24,
2395345,2395371,2022-08-16_11-00-40-052008,2395374,26,
2400506,2400532,2022-08-16_11-00-45-346361,2400536,26,
2405636,2405660,2022-08-16_11-00-50-599780,2405663,24,
2410760,2410786,2022-08-16_11-00-55-854292,2410790,26,
2415895,2415918,2022-08-16_11-01-01-112909,2415921,23,
2421072,2421097,2022-08-16_11-01-06-419980,2421100,25,
2426221,2426246,2022-08-16_11-01-11-695674,2426249,25,
2431384,2431413,2022-08-16_11-01-16-985641,2431417,29,
2436515,2436539,2022-08-16_11-01-22-245269,2436543,24,
2441653,2441680,2022-08-16_11-01-27-511272,2441683,27,
2446774,2446799,2022-08-16_11-01-32-759642,2446802,25,
2451906,2451941,2022-08-16_11-01-38-020290,2451944,35,
2457049,2457074,2022-08-16_11-01-43-288411,2457078,25,
2462187,2462211,2022-08-16_11-01-48-553454,2462215,24,
2467328,2467357,2022-08-16_11-01-53-821812,2467360,29,
2472459,2472488,2022-08-16_11-01-59-077518,2472491,29,
2477604,2477628,2022-08-16_11-02-04-348228,2477633,24,
2482754,2482778,2022-08-16_11-02-09-625914,2482781,24,
2487890,2487916,2022-08-16_11-02-14-887584,2487920,26,
2493011,2493037,2022-08-16_11-02-20-135657,2493042,26,
2498165,2498192,2022-08-16_11-02-25-415667,2498195,27,
2503274,2503302,2022-08-16_11-02-30-652393,2503306,28,
2508382,2508405,2022-08-16_11-02-35-886841,2508408,23,
2513500,2513523,2022-08-16_11-02-41-130282,2513527,23,
2518606,2518632,2022-08-16_11-02-46-367174,2518635,26,
2523715,2523758,2022-08-16_11-02-51-619412,2523761,43,
2528823,2528847,2022-08-16_11-02-56-830564,2528850,24,
2533944,2533970,2022-08-16_11-03-02-084031,2533973,26,
2539061,2539085,2022-08-16_11-03-07-323429,2539088,24,
2544187,2544214,2022-08-16_11-03-12-579219,2544217,27,
2549297,2549325,2022-08-16_11-03-17-814177,2549328,28,
2554405,2554432,2022-08-16_11-03-23-046293,2554435,27,
2559567,2559594,2022-08-16_11-03-28-339012,2559597,27,
2564675,2564702,2022-08-16_11-03-33-575003,2564705,27,
2569852,2569878,2022-08-16_11-03-38-873919,2569882,26,
2574958,2574988,2022-08-16_11-03-44-111405,2574991,30,
2580066,2580103,2022-08-16_11-03-49-346218,2580106,37,
2585174,2585198,2022-08-16_11-03-54-578504,2585201,24,
2590283,2590307,2022-08-16_11-03-59-813666,2590310,24,
2595389,2595420,2022-08-16_11-04-05-053373,2595423,31,
2600546,2600574,2022-08-16_11-04-10-331727,2600577,28,
2605653,2605680,2022-08-16_11-04-15-564681,2605683,27,
2610806,2610830,2022-08-16_11-04-20-842975,2610833,24,
2615916,2615945,2022-08-16_11-04-26-082060,2615948,29,
2621017,2621055,2022-08-16_11-04-31-305546,2621059,38,
2626126,2626152,2022-08-16_11-04-36-544580,2626155,26,
2631270,2631294,2022-08-16_11-04-41-814480,2631297,24,
2636378,2636407,2022-08-16_11-04-47-052866,2636410,29,
2641513,2641537,2022-08-16_11-04-52-314115,2641540,24,
2646621,2646647,2022-08-16_11-04-57-548911,2646650,26,
2651729,2651752,2022-08-16_11-05-02-785000,2651756,23,
2656837,2656860,2022-08-16_11-05-08-017589,2656864,23,
2662002,2662029,2022-08-16_11-05-13-313921,2662032,27,
2667108,2667142,2022-08-16_11-05-18-547611,2667145,34,
2672217,2672242,2022-08-16_11-05-23-779153,2672245,25,
2677370,2677394,2022-08-16_11-05-29-057689,2677397,24,
2682477,2682504,2022-08-16_11-05-34-294787,2682507,27,
2687628,2687654,2022-08-16_11-05-39-572690,2687658,26,
2692735,2692762,2022-08-16_11-05-44-806702,2692765,27,
2697875,2697900,2022-08-16_11-05-50-073077,2697904,25,
2702999,2703024,2022-08-16_11-05-55-319692,2703027,25,
2708145,2708176,2022-08-16_11-06-00-603892,2708179,31,
2713280,2713329,2022-08-16_11-06-05-885170,2713333,49,
2718433,2718457,2022-08-16_11-06-11-135572,2718460,24,
2723573,2723598,2022-08-16_11-06-16-404955,2723601,25,
2728742,2728768,2022-08-16_11-06-21-702936,2728771,26,
2733893,2733918,2022-08-16_11-06-26-981850,2733921,25,
2739017,2739043,2022-08-16_11-06-32-232562,2739046,26,
2744125,2744149,2022-08-16_11-06-37-466955,2744152,24,
2749236,2749264,2022-08-16_11-06-42-704606,2749267,28,
2754343,2754368,2022-08-16_11-06-47-939234,2754371,25,
2759452,2759477,2022-08-16_11-06-53-174009,2759480,25,
2764560,2764586,2022-08-16_11-06-58-408365,2764591,26,
2769709,2769738,2022-08-16_11-07-03-691286,2769742,29,
2774812,2774842,2022-08-16_11-07-08-915713,2774845,30,
2779919,2779942,2022-08-16_11-07-14-148157,2779946,23,
2785024,2785121,2022-08-16_11-07-19-455223,2785125,97,
2790132,2790164,2022-08-16_11-07-24-615596,2790169,32,
2795247,2795326,2022-08-16_11-07-29-907376,2795331,79,
2800383,2800439,2022-08-16_11-07-35-131783,2800445,56,
2805469,2805522,2022-08-16_11-07-40-352636,2805526,53,
2810618,2815725,2022-08-16_11-07-45-800086,2815730,5107,
2815730,2815810,2022-08-16_11-07-50-898996,2815816,80,
2820873,2820905,2022-08-16_11-07-56-114289,2820911,32,
2825979,2826007,2022-08-16_11-08-01-349081,2826011,28,
2831086,2831112,2022-08-16_11-08-06-582878,2831115,26,
2836194,2836296,2022-08-16_11-08-11-885694,2836299,102,
2841301,2841326,2022-08-16_11-08-17-049598,2841329,25,
2846421,2846483,2022-08-16_11-08-22-336311,2846486,62,
2851525,2851601,2022-08-16_11-08-27-562135,2851606,76,
2856635,2856681,2022-08-16_11-08-32-776753,2856684,46,
2861750,2861779,2022-08-16_11-08-38-004659,2861782,29,
2866854,2866890,2022-08-16_11-08-43-238246,2866896,36,
2872012,2872071,2022-08-16_11-08-48-552807,2872076,59,
2877145,2877183,2022-08-16_11-08-53-781250,2877189,38,
2882289,2882314,2022-08-16_11-08-59-051905,2882317,25,
2887434,2887465,2022-08-16_11-09-04-322163,2887468,31,
2892540,2892564,2022-08-16_11-09-09-555093,2892567,24,
2897698,2897724,2022-08-16_11-09-14-840595,2897727,26,
2902815,2902855,2022-08-16_11-09-20-094589,2902861,40,
2907949,2907977,2022-08-16_11-09-25-350142,2907981,28,
2913066,2913122,2022-08-16_11-09-30-623645,2913125,56,
2918173,2918241,2022-08-16_11-09-35-863928,2918249,68,
2923337,2923414,2022-08-16_11-09-41-172485,2923418,77,
2928459,2928484,2022-08-16_11-09-46-366371,2928487,25,
2933567,2933631,2022-08-16_11-09-51-632807,2933637,64,
2938688,2938715,2022-08-16_11-09-56-852841,2938718,27,
2943791,2943822,2022-08-16_11-10-02-082772,2943827,31,
2948900,2948926,2022-08-16_11-10-07-317133,2948930,26,
2954005,2954032,2022-08-16_11-10-12-548606,2954035,27,
2959116,2959139,2022-08-16_11-10-17-784259,2959143,23,
2964272,2964296,2022-08-16_11-10-23-069372,2964299,24,
2969379,2969409,2022-08-16_11-10-28-301853,2969412,30,
2974490,2974517,2022-08-16_11-10-33-542395,2974520,27,
2979604,2979677,2022-08-16_11-10-38-826403,2979681,73,
2984743,2984792,2022-08-16_11-10-44-064233,2984798,49,
2989861,2989885,2022-08-16_11-10-49-288215,2989889,24,
2994968,2994992,2022-08-16_11-10-54-524037,2994996,24,
3000082,3000106,2022-08-16_11-10-59-764813,3000110,24,
3005193,3005251,2022-08-16_11-11-05-032761,3005254,58,
3010349,3010373,2022-08-16_11-11-10-282421,3010376,24,
3015519,3015573,2022-08-16_11-11-15-602694,3015578,54,
3020627,3020661,2022-08-16_11-11-20-821653,3020666,34,
3025732,3030867,2022-08-16_11-11-26-048486,3030883,5135,
3030906,3030949,2022-08-16_11-11-31-369561,3030952,43,
3036004,3036060,2022-08-16_11-11-36-595185,3036066,56,
3041112,3041146,2022-08-16_11-11-41-814385,3041149,34,
3046216,3046249,2022-08-16_11-11-47-041608,3046254,33,
3051355,3051452,2022-08-16_11-11-52-364902,3051457,97,
3056489,3056513,2022-08-16_11-11-57-566258,3056516,24,
3061604,3061629,2022-08-16_11-12-02-808030,3061632,25,
3066707,3071853,2022-08-16_11-12-08-233307,3071859,5146,
3071859,3071925,2022-08-16_11-12-13-358128,3071928,66,
3076969,3077025,2022-08-16_11-12-18-579115,3077031,56,
3082075,3082108,2022-08-16_11-12-23-792099,3082112,33,
3087184,3087209,2022-08-16_11-12-29-022494,3087213,25,
3092302,3092326,2022-08-16_11-12-34-267486,3092330,24,
3097414,3097507,2022-08-16_11-12-39-568121,3097513,93,
3102574,3102604,2022-08-16_11-12-44-794022,3102608,30,
3107683,3112786,2022-08-16_11-12-50-215931,3112791,5103,
3112792,3112885,2022-08-16_11-12-55-332728,3112888,93,
3117923,3117947,2022-08-16_11-13-00-522052,3117951,24,
3123038,3123086,2022-08-16_11-13-05-783079,3123089,48,
3128149,3128181,2022-08-16_11-13-11-006933,3128184,32,
3133253,3133276,2022-08-16_11-13-16-230165,3133279,23,
3138405,3138491,2022-08-16_11-13-21-558024,3138497,86,
3143511,3143565,2022-08-16_11-13-26-770425,3143568,54,
3148619,3148665,2022-08-16_11-13-31-998162,3148669,46,
3153728,3153757,2022-08-16_11-13-37-222522,3153761,29,
3158833,3158870,2022-08-16_11-13-42-447906,3158876,37,
3163934,3169077,2022-08-16_11-13-47-673462,3169086,5143,
3169110,3169151,2022-08-16_11-13-52-991998,3169157,41,
3174197,3174235,2022-08-16_11-13-58-205848,3174239,38,
3179306,3179333,2022-08-16_11-14-03-428349,3179338,27,
3184410,3184437,2022-08-16_11-14-08-660047,3184440,27,
3189520,3189544,2022-08-16_11-14-13-893227,3189547,24,
3194621,3194647,2022-08-16_11-14-19-119335,3194650,26,
3199789,3199812,2022-08-16_11-14-24-415588,3199816,23,
3204897,3204924,2022-08-16_11-14-29-653656,3204931,27,
3209997,3210020,2022-08-16_11-14-34-881403,3210024,23,
3215104,3215129,2022-08-16_11-14-40-113317,3215132,25,
3220236,3220308,2022-08-16_11-14-45-417498,3220311,72,
3225388,3225426,2022-08-16_11-14-50-647812,3225433,38,
3230522,3230546,2022-08-16_11-14-55-909420,3230550,24,
3235660,3235715,2022-08-16_11-15-01-197134,3235718,55,
3240761,3240785,2022-08-16_11-15-06-400987,3240787,24,
3245867,3245896,2022-08-16_11-15-11-637549,3245900,29,
3250975,3251000,2022-08-16_11-15-16-866596,3251003,25,
3256110,3256134,2022-08-16_11-15-22-127792,3256137,24,
3261236,3261263,2022-08-16_11-15-27-381062,3261267,27,
3266372,3266398,2022-08-16_11-15-32-650137,3266402,26,
3271480,3271506,2022-08-16_11-15-37-881957,3271509,26,
3276594,3276618,2022-08-16_11-15-43-121732,3276621,24,
3281742,3281772,2022-08-16_11-15-48-398114,3281775,30,
3286881,3286906,2022-08-16_11-15-53-663257,3286909,25,
3292010,3292033,2022-08-16_11-15-58-918515,3292036,23,
3297172,3297195,2022-08-16_11-16-04-208813,3297199,23,
3302330,3302355,2022-08-16_11-16-09-496553,3302360,25,
3307466,3307490,2022-08-16_11-16-14-757441,3307494,24,
3312574,3312600,2022-08-16_11-16-19-991865,3312604,26,
3317712,3317738,2022-08-16_11-16-25-258004,3317741,26,
3322818,3322849,2022-08-16_11-16-30-489651,3322853,31,
3327927,3327951,2022-08-16_11-16-35-724453,3327954,24,
3333036,3333063,2022-08-16_11-16-40-959266,3333067,27,
3338143,3338178,2022-08-16_11-16-46-200868,3338182,35,
3343251,3343276,2022-08-16_11-16-51-429453,3343280,25,
3348395,3348419,2022-08-16_11-16-56-701837,3348422,24,
3353505,3353531,2022-08-16_11-17-01-939366,3353534,26,
3358611,3358635,2022-08-16_11-17-07-170868,3358638,24,
3363769,3363793,2022-08-16_11-17-12-457249,3363796,24,
3368875,3368902,2022-08-16_11-17-17-692774,3368905,27,
3373989,3374014,2022-08-16_11-17-22-931905,3374019,25,
3379094,3379118,2022-08-16_11-17-28-162788,3379121,24,
3384251,3384288,2022-08-16_11-17-33-457182,3384292,37,
3389372,3389399,2022-08-16_11-17-38-696128,3389403,27,
3394480,3394503,2022-08-16_11-17-43-925187,3394506,23,
3399632,3399658,2022-08-16_11-17-49-211473,3399662,26,
3404740,3404764,2022-08-16_11-17-54-443567,3404767,24,
3409848,3409874,2022-08-16_11-17-59-677793,3409877,26,
3415005,3415029,2022-08-16_11-18-04-961973,3415032,24,
3420116,3420145,2022-08-16_11-18-10-197768,3420149,29,
3425241,3425265,2022-08-16_11-18-15-449819,3425269,24,
3430343,3430388,2022-08-16_11-18-20-684234,3430391,45,
3435469,3435491,2022-08-16_11-18-25-930447,3435495,22,
3440573,3440599,2022-08-16_11-18-31-162776,3440602,26,
3445730,3445754,2022-08-16_11-18-36-447133,3445758,24,
3450836,3450862,2022-08-16_11-18-41-677954,3450865,26,
3455987,3456011,2022-08-16_11-18-46-958552,3456014,24,
3461094,3461119,2022-08-16_11-18-52-192176,3461123,25,
3466246,3466271,2022-08-16_11-18-57-470449,3466274,25,
3471353,3471380,2022-08-16_11-19-02-702924,3471383,27,