RD,TS_received,TS_sent,AK,RoundTrip,
360660,360716,2022-08-04_12-13-53-637090,360719,56,
365790,365815,2022-08-04_12-13-58-859221,365818,25,
370897,370922,2022-08-04_12-14-04-096540,370925,25,
376023,376083,2022-08-04_12-14-09-387509,376086,60,
381121,386274,2022-08-04_12-14-14-574146,386283,5153,
386297,386381,2022-08-04_12-14-19-938687,386385,84,
391400,391473,2022-08-04_12-14-25-156385,391476,73,
396507,396531,2022-08-04_12-14-30-344689,396534,24,
401631,401680,2022-08-04_12-14-35-609555,401686,49,
406737,406762,2022-08-04_12-14-40-830227,406765,25,
411855,411956,2022-08-04_12-14-46-153528,411959,101,
416953,416989,2022-08-04_12-14-51-304870,416992,36,
422071,422147,2022-08-04_12-14-56-594078,422151,76,
427222,432325,2022-08-04_12-15-02-025882,432329,5103,
432329,437456,2022-08-04_12-15-07-247420,437459,5127,
437460,437484,2022-08-04_12-15-12-314972,437487,24,
442578,442638,2022-08-04_12-15-17-596331,442641,60,
447685,447728,2022-08-04_12-15-22-816664,447731,43,
452793,452824,2022-08-04_12-15-28-037896,452827,31,
457894,457919,2022-08-04_12-15-33-261523,457922,25,
463003,463027,2022-08-04_12-15-38-495149,463030,24,
468110,468201,2022-08-04_12-15-43-799225,468206,91,
473226,473301,2022-08-04_12-15-49-023006,473305,75,
478356,483459,2022-08-04_12-15-54-253252,483471,5103,
483488,483582,2022-08-04_12-15-59-560649,483585,94,
488570,488595,2022-08-04_12-16-04-698644,488598,25,
493673,493696,2022-08-04_12-16-09-927290,493700,23,
498780,498880,2022-08-04_12-16-15-236440,498883,100,
503907,503933,2022-08-04_12-16-20-415072,503937,26,
509023,509074,2022-08-04_12-16-25-691577,509077,51,
514124,514174,2022-08-04_12-16-30-910569,514180,50,
519239,519264,2022-08-04_12-16-36-127420,519267,25,
524339,524364,2022-08-04_12-16-41-357598,524367,25,
529456,529558,2022-08-04_12-16-46-679363,529564,102,
534556,534650,2022-08-04_12-16-51-896448,534653,94,
539663,539747,2022-08-04_12-16-57-125150,539751,84,
544778,544847,2022-08-04_12-17-02-350211,544850,69,
549955,549980,2022-08-04_12-17-07-609236,549983,25,
555108,555140,2022-08-04_12-17-12-899628,555143,32,
560211,560246,2022-08-04_12-17-18-123399,560251,35,
565315,565341,2022-08-04_12-17-23-357519,565345,26,
570421,575596,2022-08-04_12-17-28-761482,575599,5175,
575600,575624,2022-08-04_12-17-33-894733,575627,24,
580731,580758,2022-08-04_12-17-39-157070,580761,27,
585875,585905,2022-08-04_12-17-44-433701,585908,30,
591016,591041,2022-08-04_12-17-49-695976,591044,25,
596132,596197,2022-08-04_12-17-54-976211,596201,65,
601271,601295,2022-08-04_12-18-00-206513,601298,24,
606373,606398,2022-08-04_12-18-05-437733,606401,25,
611523,611602,2022-08-04_12-18-10-770711,611605,79,
616652,616681,2022-08-04_12-18-15-974941,616684,29,
621755,621877,2022-08-04_12-18-21-298315,626856,122,
626869,626894,2022-08-04_12-18-26-444842,626897,25,
631978,632082,2022-08-04_12-18-31-761183,632086,104,
637079,637102,2022-08-04_12-18-36-905782,637106,23,
642252,642278,2022-08-04_12-18-42-212796,642281,26,
647398,647457,2022-08-04_12-18-47-515635,647463,59,
652507,652572,2022-08-04_12-18-52-758724,652575,65,
657621,657645,2022-08-04_12-18-57-961702,657649,24,
662728,662752,2022-08-04_12-19-03-198424,662756,24,
667898,667940,2022-08-04_12-19-08-509191,667946,42,
672995,673022,2022-08-04_12-19-13-717639,673026,27,
678115,678140,2022-08-04_12-19-18-967747,678144,25,
683259,683282,2022-08-04_12-19-24-240608,683286,23,
688366,688415,2022-08-04_12-19-29-497216,688418,49,
693476,693502,2022-08-04_12-19-34-710416,693506,26,
698582,698608,2022-08-04_12-19-39-943546,698612,26,
703756,703782,2022-08-04_12-19-45-245479,703785,26,
708864,708889,2022-08-04_12-19-50-477073,708892,25,
713972,713998,2022-08-04_12-19-55-713845,714001,26,
719134,719193,2022-08-04_12-20-01-040717,719196,59,
724268,724291,2022-08-04_12-20-06-270946,724294,23,
729399,729423,2022-08-04_12-20-11-528713,729426,24,
734542,734576,2022-08-04_12-20-16-809360,734579,34,
739641,739670,2022-08-04_12-20-22-028249,739673,29,
744748,744774,2022-08-04_12-20-27-257680,744779,26,
749913,749950,2022-08-04_12-20-32-549393,749953,37,
755066,755091,2022-08-04_12-20-37-833074,755094,25,
760206,760254,2022-08-04_12-20-43-127626,760258,48,
765338,770479,2022-08-04_12-20-48-551004,770484,5141,
770485,770549,2022-08-04_12-20-53-675249,770552,64,
775627,775662,2022-08-04_12-20-58-907945,775668,35,
780783,780835,2022-08-04_12-21-04-222247,780838,52,
785890,785932,2022-08-04_12-21-09-442340,785936,42,
790999,791025,2022-08-04_12-21-14-667421,791028,26,
796148,796172,2022-08-04_12-21-19-943910,796176,24,
801292,801315,2022-08-04_12-21-25-214034,801319,23,
806396,806419,2022-08-04_12-21-30-444122,806423,23,
811572,811611,2022-08-04_12-21-35-762226,811615,39,
816700,816727,2022-08-04_12-21-41-001704,816730,27,
821866,821903,2022-08-04_12-21-46-309758,821907,37,
826973,826998,2022-08-04_12-21-51-529697,827001,25,
832074,832099,2022-08-04_12-21-56-757727,832103,25,
837179,837277,2022-08-04_12-22-02-069287,837280,98,
842315,842340,2022-08-04_12-22-07-257949,842344,25,
847431,847476,2022-08-04_12-22-12-519066,847481,45,
852589,852661,2022-08-04_12-22-17-837869,852671,72,
857696,862854,2022-08-04_12-22-23-061209,862871,5158,
862894,862951,2022-08-04_12-22-28-386540,862954,57,
868003,868060,2022-08-04_12-22-33-619365,868066,57,
873122,873146,2022-08-04_12-22-38-838288,873150,24,
878224,878248,2022-08-04_12-22-44-069489,878252,24,
883331,883356,2022-08-04_12-22-49-306299,883359,25,
888462,888527,2022-08-04_12-22-54-601567,888530,65,
893562,893586,2022-08-04_12-22-59-791814,893589,24,
898680,898704,2022-08-04_12-23-05-039608,898708,24,
903796,903819,2022-08-04_12-23-10-281453,903823,23,
908899,908925,2022-08-04_12-23-15-512009,908928,26,
914008,914032,2022-08-04_12-23-20-751715,914036,24,
919116,919141,2022-08-04_12-23-25-986408,919144,25,
924224,924292,2022-08-04_12-23-31-266776,924295,68,
929399,929475,2022-08-04_12-23-36-579765,929478,76,
934523,934583,2022-08-04_12-23-41-814372,934586,60,
939662,939685,2022-08-04_12-23-47-041745,939690,23,
944817,944884,2022-08-04_12-23-52-365841,944888,67,
949920,949943,2022-08-04_12-23-57-550828,949946,23,
955053,955077,2022-08-04_12-24-02-815132,955080,24,
960164,960188,2022-08-04_12-24-08-050308,960191,24,
965271,965296,2022-08-04_12-24-13-281321,965299,25,
970386,970460,2022-08-04_12-24-18-578466,970463,74,
975501,975551,2022-08-04_12-24-23-793645,975555,50,
980616,980640,2022-08-04_12-24-29-011667,980643,24,
985734,985759,2022-08-04_12-24-34-258894,985762,25,
990850,990877,2022-08-04_12-24-39-502873,990880,27,
995960,996038,2022-08-04_12-24-44-789613,996043,78,
1001113,1001139,2022-08-04_12-24-50-018159,1001143,26,
1006215,1006239,2022-08-04_12-24-55-251516,1006242,24,
1011330,1011414,2022-08-04_12-25-00-555517,1011417,84,
1016431,1016456,2022-08-04_12-25-05-722137,1016460,25,
1021592,1021616,2022-08-04_12-25-11-015025,1021619,24,
1026700,1026723,2022-08-04_12-25-16-252459,1026727,23,
1031807,1031902,2022-08-04_12-25-21-551708,1031908,95,
1036941,1036993,2022-08-04_12-25-26-776316,1036996,52,
1042050,1042089,2022-08-04_12-25-31-999189,1042092,39,
1047157,1047182,2022-08-04_12-25-37-221351,1047187,25,
1052260,1052384,2022-08-04_12-25-42-545144,1057377,124,
1057392,1057416,2022-08-04_12-25-47-706611,1057419,24,
1062537,1062570,2022-08-04_12-25-52-991307,1062574,33,
1067660,1067682,2022-08-04_12-25-58-229921,1067685,22,
1072769,1072803,2022-08-04_12-26-03-461798,1072806,34,
1077877,1077899,2022-08-04_12-26-08-696650,1077903,22,
1083045,1083070,2022-08-04_12-26-13-994916,1083074,25,
1088146,1088173,2022-08-04_12-26-19-221847,1088176,27,
1093251,1093275,2022-08-04_12-26-24-452852,1093279,24,
1098358,1098445,2022-08-04_12-26-29-751146,1098449,87,
1103469,1103493,2022-08-04_12-26-34-926585,1103496,24,
1108578,1108602,2022-08-04_12-26-40-161963,1108607,24,
1113693,1113732,2022-08-04_12-26-45-414095,1113735,39,
1118803,1123898,2022-08-04_12-26-50-761624,1123907,5095,
1123928,1129005,2022-08-04_12-26-56-002575,1129015,5077,
1129028,1129113,2022-08-04_12-27-01-189131,1129117,85,
1134118,1134157,2022-08-04_12-27-06-353728,1134160,39,
1139262,1139286,2022-08-04_12-27-11-616152,1139289,24,
1144375,1144398,2022-08-04_12-27-16-862318,1144402,23,
1149481,1149505,2022-08-04_12-27-22-093924,1149509,24,
1154586,1154610,2022-08-04_12-27-27-328138,1154614,24,
1159697,1159720,2022-08-04_12-27-32-568947,1159724,23,
1164832,1164890,2022-08-04_12-27-37-861776,1164893,58,
1170001,1170023,2022-08-04_12-27-43-127615,1170026,22,
1175117,1175162,2022-08-04_12-27-48-397434,1175172,45,
1180226,1180254,2022-08-04_12-27-53-617794,1180257,28,
1185324,1185351,2022-08-04_12-27-58-841421,1185354,27,
1190525,1190550,2022-08-04_12-28-04-170322,1190553,25,
1195634,1195662,2022-08-04_12-28-09-405089,1195666,28,
1200775,1200799,2022-08-04_12-28-14-675170,1200802,24,
1205917,1205942,2022-08-04_12-28-19-947232,1205945,25,
1211023,1211047,2022-08-04_12-28-25-177677,1211050,24,
1216164,1216190,2022-08-04_12-28-30-446763,1216193,26,
1221312,1221337,2022-08-04_12-28-35-723977,1221340,25,
1226480,1226503,2022-08-04_12-28-41-018690,1226506,23,
1231588,1231620,2022-08-04_12-28-46-252021,1231624,32,
1236695,1236719,2022-08-04_12-28-51-481984,1236722,24,
1241802,1241827,2022-08-04_12-28-56-722600,1241830,25,
1246912,1246937,2022-08-04_12-29-01-957368,1246940,25,
1252076,1252100,2022-08-04_12-29-07-251715,1252103,24,
1257184,1257219,2022-08-04_12-29-12-493803,1257222,35,
1262292,1262316,2022-08-04_12-29-17-728225,1262319,24,
1267423,1267447,2022-08-04_12-29-22-984797,1267451,24,
1272531,1272554,2022-08-04_12-29-28-219978,1272558,23,
1277639,1277666,2022-08-04_12-29-33-459587,1277669,27,
1282789,1282819,2022-08-04_12-29-38-734819,1282823,30,
1287897,1287922,2022-08-04_12-29-43-968163,1287925,25,
1293004,1293105,2022-08-04_12-29-49-220218,1293108,101,
1298257,1298281,2022-08-04_12-29-54-587509,1298284,24,
1303425,1303451,2022-08-04_12-29-59-882642,1303455,26,
1308532,1308556,2022-08-04_12-30-05-118645,1308559,24,
1313699,1313724,2022-08-04_12-30-10-414360,1313727,25,
1318814,1318838,2022-08-04_12-30-15-657043,1318842,24,
1323916,1323939,2022-08-04_12-30-20-884430,1323943,23,
1329023,1329048,2022-08-04_12-30-26-115942,1329051,25,
1334145,1334169,2022-08-04_12-30-31-365766,1334172,24,
1339253,1339278,2022-08-04_12-30-36-604859,1339281,25,
1344362,1344393,2022-08-04_12-30-41-842790,1344397,31,
1349469,1349493,2022-08-04_12-30-47-074097,1349497,24,
1354577,1354624,2022-08-04_12-30-52-328388,1354629,47,
1359688,1359711,2022-08-04_12-30-57-545680,1359714,23,
1364838,1364874,2022-08-04_12-31-02-830769,1364877,36,
1369948,1369972,2022-08-04_12-31-08-061006,1369975,24,
1375055,1375084,2022-08-04_12-31-13-296391,1375087,29,
1380162,1380184,2022-08-04_12-31-18-527475,1380187,22,
1385304,1385328,2022-08-04_12-31-23-797246,1385331,24,
1390413,1390437,2022-08-04_12-31-29-033146,1390441,24,
1395521,1395544,2022-08-04_12-31-34-269697,1395548,23,
1400628,1400653,2022-08-04_12-31-39-506172,1400656,25,
1405767,1405792,2022-08-04_12-31-44-767993,1405795,25,
1410875,1410899,2022-08-04_12-31-50-008551,1410903,24,
1415983,1416009,2022-08-04_12-31-55-244748,1416013,26,
1421091,0,,1426217,-1421091,
1426217,1426242,2022-08-04_12-32-05-730019,1426245,25,
1431358,1431382,2022-08-04_12-32-10-998549,1431385,24,
1436467,1436493,2022-08-04_12-32-16-238467,1436496,26,
1441611,1441635,2022-08-04_12-32-21-507587,1441639,24,
1446732,1446762,2022-08-04_12-32-26-758111,1446765,30,
1451840,1451870,2022-08-04_12-32-31-997975,1451873,30,
1456992,1457015,2022-08-04_12-32-37-274336,1457019,23,
1462141,1462165,2022-08-04_12-32-42-548729,1462168,24,
1467276,1467301,2022-08-04_12-32-47-811792,1467305,25,
1472390,1472439,2022-08-04_12-32-53-067221,1472442,49,
1477524,1477551,2022-08-04_12-32-58-320997,1477554,27,
1482679,1482703,2022-08-04_12-33-03-600992,1482706,24,
1487819,1487844,2022-08-04_12-33-08-867635,1487847,25,
1492948,1492972,2022-08-04_12-33-14-126044,1492975,24,
1498078,1498102,2022-08-04_12-33-19-384494,1498105,24,
1503186,1503212,2022-08-04_12-33-24-621056,1503216,26,
1508327,1508352,2022-08-04_12-33-29-885259,1508355,25,
1513463,1513489,2022-08-04_12-33-35-151964,1513492,26,
1518613,1518637,2022-08-04_12-33-40-431053,1518641,24,
1523746,1523776,2022-08-04_12-33-45-690503,1523780,30,
1528889,1528919,2022-08-04_12-33-50-966151,1528922,30,
1534035,1534061,2022-08-04_12-33-56-239363,1534064,26,
1539144,1539170,2022-08-04_12-34-01-471474,1539174,26,
1544259,1544283,2022-08-04_12-34-06-714950,1544287,24,
1549367,1549397,2022-08-04_12-34-11-956660,1549401,30,
1554476,1554501,2022-08-04_12-34-17-186712,1554504,25,
1559583,1559606,2022-08-04_12-34-22-420389,1559610,23,
1564692,1564718,2022-08-04_12-34-27-656061,1564721,26,
1569838,1569861,2022-08-04_12-34-32-931633,1569865,23,
1574978,1575005,2022-08-04_12-34-38-198275,1575009,27,
1580108,1580132,2022-08-04_12-34-43-458201,1580135,24,
1585264,1585290,2022-08-04_12-34-48-742766,1585294,26,
1590408,1590440,2022-08-04_12-34-54-016456,1590443,32,
1595555,1595579,2022-08-04_12-34-59-289445,1595582,24,
1600708,1600734,2022-08-04_12-35-04-570433,1600737,26,
1605835,1605858,2022-08-04_12-35-09-823200,1605862,23,
1610935,1610959,2022-08-04_12-35-15-053927,1610962,24,
1616046,1616071,2022-08-04_12-35-20-296029,1616074,25,
1621200,1621225,2022-08-04_12-35-25-572547,1621228,25,
1626310,1626335,2022-08-04_12-35-30-810168,1626338,25,
1631475,1636579,2022-08-04_12-35-36-274872,1636582,5104,
1636582,1636607,2022-08-04_12-35-41-341704,1636610,25,
1641755,1641777,2022-08-04_12-35-46-639157,1641780,22,
1646863,1646888,2022-08-04_12-35-51-876634,1646891,25,
1652023,1652053,2022-08-04_12-35-57-167237,1652056,30,
1657129,1657152,2022-08-04_12-36-02-396315,1657155,23,
1662277,1662302,2022-08-04_12-36-07-677678,1662305,25,
1667395,1667423,2022-08-04_12-36-12-919874,1667426,28,
1672502,1672531,2022-08-04_12-36-18-152455,1672534,29,
1677605,1677628,2022-08-04_12-36-23-386271,1677632,23,
1682709,1682811,2022-08-04_12-36-28-690061,1682814,102,
1687817,1687842,2022-08-04_12-36-33-852181,1687846,25,
1692926,1693001,2022-08-04_12-36-39-139762,1693004,75,
1698040,1698064,2022-08-04_12-36-44-327234,1698068,24,
1703149,1703196,2022-08-04_12-36-49-583920,1703199,47,
1708290,1708313,2022-08-04_12-36-54-832706,1708317,23,
1713399,1713483,2022-08-04_12-37-00-131947,1713487,84,
1718554,1718586,2022-08-04_12-37-05-360451,1718590,32,
1723657,1723687,2022-08-04_12-37-10-588234,1723690,30,
1728760,1728788,2022-08-04_12-37-15-818134,1728791,28,
1733853,1733884,2022-08-04_12-37-21-040767,1733887,31,
1738975,1738998,2022-08-04_12-37-26-280156,1739001,23,
1744100,1744125,2022-08-04_12-37-31-534043,1744128,25,
1749207,1749248,2022-08-04_12-37-36-783836,1749251,41,
1754324,1754348,2022-08-04_12-37-42-015053,1754352,24,
1759430,1759453,2022-08-04_12-37-47-246425,1759456,23,
1764531,1764568,2022-08-04_12-37-52-488242,1764571,37,
1769646,1769670,2022-08-04_12-37-57-719951,1769674,24,
1774763,1774842,2022-08-04_12-38-03-009984,1774845,79,
1779912,1779929,2022-08-04_12-38-08-239462,1779941,17,
1785018,1785065,2022-08-04_12-38-13-498705,1785069,47,
1790127,1790217,2022-08-04_12-38-18-775997,1790220,90,
1795290,1795319,2022-08-04_12-38-24-003459,1795323,29,
1800389,1800413,2022-08-04_12-38-29-229199,1800416,24,
1805555,1805601,2022-08-04_12-38-34-548600,1805604,46,
1810745,1810797,2022-08-04_12-38-39-870999,1810801,52,
1815851,1815896,2022-08-04_12-38-45-094954,1815899,45,
1820957,1820988,2022-08-04_12-38-50-310009,1820991,31,
1826127,1826187,2022-08-04_12-38-55-642853,1826190,60,
1831234,1831278,2022-08-04_12-39-00-864698,1831281,44,
1836343,1836372,2022-08-04_12-39-06-084488,1836375,29,
1841449,1841571,2022-08-04_12-39-11-410247,1846548,122,
1846561,1846586,2022-08-04_12-39-16-553857,1846589,25,
1851667,1851695,2022-08-04_12-39-21-783524,1851698,28,
1856775,1856884,2022-08-04_12-39-27-090438,1861886,109,
1861909,1861946,2022-08-04_12-39-32-295062,1861949,37,
1866999,1867049,2022-08-04_12-39-37-523962,1867053,50,
1872105,1872143,2022-08-04_12-39-42-745335,1872147,38,
1877270,1877294,2022-08-04_12-39-48-024726,1877297,24,
1882387,1882436,2022-08-04_12-39-53-287051,1882439,49,
1887488,1887529,2022-08-04_12-39-58-514215,1887533,41,
1892597,1892622,2022-08-04_12-40-03-732334,1892626,25,
1897711,1897829,2022-08-04_12-40-09-073478,1902810,118,
1902825,1902849,2022-08-04_12-40-14-216625,1902853,24,
1907923,1907947,2022-08-04_12-40-19-440918,1907951,24,
1913030,1913132,2022-08-04_12-40-24-734163,1913136,102,
1918147,1918171,2022-08-04_12-40-29-924015,1918175,24,
1923285,1923308,2022-08-04_12-40-35-183947,1923312,23,
1928472,1928497,2022-08-04_12-40-40-500635,1928500,25,
1933582,1933650,2022-08-04_12-40-45-785025,1933653,68,
1938687,1938710,2022-08-04_12-40-50-970870,1938714,23,
1943794,1943818,2022-08-04_12-40-56-204264,1943821,24,
1948948,1948978,2022-08-04_12-41-01-491436,1948981,30,
1954105,1954129,2022-08-04_12-41-06-772234,1954132,24,
1959248,1959297,2022-08-04_12-41-12-067688,1959300,49,
1964380,1964470,2022-08-04_12-41-17-367610,1964473,90,
1969509,1969565,2022-08-04_12-41-22-588795,1969568,56,
1974617,1974654,2022-08-04_12-41-27-809975,1974658,37,
1979770,1979801,2022-08-04_12-41-33-075133,1979805,31,
1984896,1984920,2022-08-04_12-41-38-328966,1984923,24,
1990067,1990170,2022-08-04_12-41-43-707753,1990174,103,
1995175,1995238,2022-08-04_12-41-48-902953,1995241,63,
2000282,2000332,2022-08-04_12-41-54-125584,2000336,50,
2005381,2005405,2022-08-04_12-41-59-325229,2005408,24,
2010553,2010581,2022-08-04_12-42-04-625138,2010584,28,
2015710,2015733,2022-08-04_12-42-09-908956,2015737,23,
2020817,2020840,2022-08-04_12-42-15-142742,2020844,23,
2025946,2026006,2022-08-04_12-42-20-437023,2026010,60,
2031060,2031115,2022-08-04_12-42-25-667136,2031121,55,
2036181,2036207,2022-08-04_12-42-30-892300,2036210,26,
2041289,2041311,2022-08-04_12-42-36-124186,2041315,22,
2046388,2046411,2022-08-04_12-42-41-352455,2046415,23,
2051496,2051520,2022-08-04_12-42-46-588554,2051524,24,
2056603,2056630,2022-08-04_12-42-51-827594,2056633,27,
2061722,2061780,2022-08-04_12-42-57-104839,2061785,58,
2066837,2066862,2022-08-04_12-43-02-312297,2066865,25,
2071950,2077048,2022-08-04_12-43-07-653132,2077057,5098,
2077071,2077096,2022-08-04_12-43-12-798549,2077099,25,
2082161,2082197,2022-08-04_12-43-18-028022,2082200,36,
2087267,2087292,2022-08-04_12-43-23-253436,2087295,25,
2092391,2092423,2022-08-04_12-43-28-502190,2092427,32,
2097507,2097549,2022-08-04_12-43-33-763852,2097552,42,
2102617,2102669,2022-08-04_12-43-39-001993,2102672,52,
2107721,2107746,2022-08-04_12-43-44-214145,2107749,25,
2112828,2112851,2022-08-04_12-43-49-448452,2112854,23,
2117935,2117959,2022-08-04_12-43-54-681668,2117962,24,
2123045,2123121,2022-08-04_12-43-59-975329,2123125,76,
2128159,2128218,2022-08-04_12-44-05-200516,2128222,59,
2133286,2133319,2022-08-04_12-44-10-423210,2133322,33,
2138393,2138417,2022-08-04_12-44-15-650457,2138421,24,
2143494,2143522,2022-08-04_12-44-20-885271,2143525,28,
2148655,2148678,2022-08-04_12-44-26-170570,2148683,23,
2153762,2153796,2022-08-04_12-44-31-413965,2153800,34,
2158915,2158939,2022-08-04_12-44-36-683411,2158942,24,
2164029,2164081,2022-08-04_12-44-41-953265,2164084,52,
2169136,2169215,2022-08-04_12-44-47-210497,2169218,79,
2174259,2174284,2022-08-04_12-44-52-407834,2174288,25,
2179367,2179397,2022-08-04_12-44-57-643225,2179402,30,
2184475,2184503,2022-08-04_12-45-02-880334,2184506,28,
2189686,2189771,2022-08-04_12-45-08-279873,2189774,85,
2194795,2194820,2022-08-04_12-45-13-453776,2194824,25,
2199913,2199961,2022-08-04_12-45-18-722723,2199964,48,
2205015,2205039,2022-08-04_12-45-23-930221,2205042,24,
2210128,2210150,2022-08-04_12-45-29-169197,2210153,22,
2215292,2215348,2022-08-04_12-45-34-494529,2215351,56,
2220400,2220423,2022-08-04_12-45-39-696989,2220426,23,
2225536,2225637,2022-08-04_12-45-45-039911,2225640,101,
2230702,2230733,2022-08-04_12-45-50-262463,2230737,31,
2235809,2235833,2022-08-04_12-45-55-490671,2235836,24,
2240911,2240941,2022-08-04_12-46-00-718030,2240946,30,
2246061,2246085,2022-08-04_12-46-05-997032,2246089,24,
2251205,2251240,2022-08-04_12-46-11-281830,2251244,35,
2256348,2256372,2022-08-04_12-46-16-542780,2256375,24,
2261465,2261506,2022-08-04_12-46-21-801889,2261512,41,
2266574,2266605,2022-08-04_12-46-27-026211,2266611,31,
2271679,2276779,2022-08-04_12-46-32-295249,2276790,5100,
2276804,2276831,2022-08-04_12-46-37-506723,2276834,27,
2281892,2281918,2022-08-04_12-46-42-721930,2281921,26,
2287037,2287097,2022-08-04_12-46-48-029005,2287100,60,
2292146,2292191,2022-08-04_12-46-53-253430,2292194,45,
2297245,2297276,2022-08-04_12-46-58-460442,2297279,31,
2302416,2302471,2022-08-04_12-47-03-788263,2302475,55,
2307537,2307560,2022-08-04_12-47-09-002649,2307563,23,
2312643,2312683,2022-08-04_12-47-14-248275,2312686,40,
2317748,2317772,2022-08-04_12-47-19-469188,2317776,24,
2322889,2322920,2022-08-04_12-47-24-746091,2322923,31,
2327998,2328049,2022-08-04_12-47-30-000572,2328052,51,
2333113,2333145,2022-08-04_12-47-35-223217,2333148,32,
2338220,2338256,2022-08-04_12-47-40-460813,2338260,36,
2343328,2343354,2022-08-04_12-47-45-689951,2343357,26,
2348491,2348534,2022-08-04_12-47-50-994856,2348537,43,
2353622,2353653,2022-08-04_12-47-56-238279,2353657,31,
2358730,2358756,2022-08-04_12-48-01-473956,2358759,26,
2363838,2363862,2022-08-04_12-48-06-711276,2363865,24,
2368945,2369010,2022-08-04_12-48-11-985295,2369014,65,
2374054,2374079,2022-08-04_12-48-17-178967,2374082,25,
2379193,2379219,2022-08-04_12-48-22-447893,2379223,26,
2384352,2384401,2022-08-04_12-48-27-757407,2384404,49,
2389460,2389503,2022-08-04_12-48-32-979013,2389506,43,
2394559,2394584,2022-08-04_12-48-38-193014,2394586,25,
2399671,2399695,2022-08-04_12-48-43-430523,2399699,24,
2404775,2404798,2022-08-04_12-48-48-662136,2404801,23,
2409931,2409958,2022-08-04_12-48-53-947778,2409961,27,
2415075,2415099,2022-08-04_12-48-59-223857,2415102,24,
2420222,2420270,2022-08-04_12-49-04-519712,2420276,48,
2425327,2425362,2022-08-04_12-49-09-738483,2425365,35,
2430435,2430460,2022-08-04_12-49-14-963556,2430464,25,
2435561,2435587,2022-08-04_12-49-20-217652,2435590,26,
2440671,2440694,2022-08-04_12-49-25-457059,2440698,23,
2445788,2445844,2022-08-04_12-49-30-731491,2445848,56,
2450903,2450942,2022-08-04_12-49-35-955787,2450945,39,
2456028,0,,2461152,-2456028,
2461153,2461176,2022-08-04_12-49-46-443941,2461179,23,
2466308,2466334,2022-08-04_12-49-51-730135,2466338,26,
2471409,2471435,2022-08-04_12-49-56-958719,2471438,26,
2476517,2476540,2022-08-04_12-50-02-189845,2476544,23,
2481678,2481729,2022-08-04_12-50-07-495603,2481732,51,
2486787,2486812,2022-08-04_12-50-12-719341,2486815,25,
2491894,2492002,2022-08-04_12-50-18-040779,2496995,108,
2497018,2497112,2022-08-04_12-50-23-270459,2497115,94,
2502104,2502128,2022-08-04_12-50-28-414203,2502132,24,
2507211,2507235,2022-08-04_12-50-33-651658,2507238,24,
2512374,2517510,2022-08-04_12-50-39-139229,2517516,5136,
2517516,2517583,2022-08-04_12-50-44-257737,2517586,67,
2522615,2522638,2022-08-04_12-50-49-438651,2522641,23,
2527732,2527776,2022-08-04_12-50-54-703147,2527780,44,
2532839,2532875,2022-08-04_12-50-59-926859,2532881,36,
2537944,2537967,2022-08-04_12-51-05-152443,2537973,23,
2543050,2543076,2022-08-04_12-51-10-382733,2543080,26,
2548159,2548258,2022-08-04_12-51-15-694621,2548262,99,
2553313,2553337,2022-08-04_12-51-20-902026,2553340,24,
2558426,2563527,2022-08-04_12-51-26-245559,2563537,5101,
2563550,2563573,2022-08-04_12-51-31-394623,2563576,23,
2568640,2568666,2022-08-04_12-51-36-616940,2568670,26,
2573747,2573842,2022-08-04_12-51-41-914508,2573847,95,
2578918,2578943,2022-08-04_12-51-47-143420,2578946,25,
2584021,2584045,2022-08-04_12-51-52-373991,2584049,24,
2589131,2589215,2022-08-04_12-51-57-676042,2589219,84,
2594239,2594320,2022-08-04_12-52-02-900628,2594326,81,
2599374,2599412,2022-08-04_12-52-08-125292,2599416,38,
2604516,2604554,2022-08-04_12-52-13-395423,2604556,38,
2609631,2609654,2022-08-04_12-52-18-622015,2609658,23,
2614747,2614813,2022-08-04_12-52-23-901342,2614819,66,
2619856,2619890,2022-08-04_12-52-29-113908,2619893,34,
2624963,2625001,2022-08-04_12-52-34-340837,2625008,38,
2630062,2630091,2022-08-04_12-52-39-560825,2630094,29,
2635225,2635291,2022-08-04_12-52-44-897340,2635294,66,
2640330,2640373,2022-08-04_12-52-50-108105,2640376,43,
2645441,2645469,2022-08-04_12-52-55-331785,2645473,28,
2650539,2650564,2022-08-04_12-53-00-552053,2650567,25,
2655680,2655706,2022-08-04_12-53-05-820427,2655710,26,
2660854,2660879,2022-08-04_12-53-11-123822,2660882,25,
2666002,2666054,2022-08-04_12-53-16-427532,2666058,52,
2671110,2671144,2022-08-04_12-53-21-648065,2671147,34,
2676248,2676271,2022-08-04_12-53-26-899516,2676275,23,
2681412,2681436,2022-08-04_12-53-32-194366,2681439,24,
2686515,2686539,2022-08-04_12-53-37-423810,2686543,24,
2691662,2691687,2022-08-04_12-53-42-699306,2691690,25,
2696810,2696843,2022-08-04_12-53-47-984824,2696846,33,
2701969,2702014,2022-08-04_12-53-53-282699,2702017,45,
2707076,2707113,2022-08-04_12-53-58-510185,2707116,37,
2712184,2712229,2022-08-04_12-54-03-742513,2712234,45,
2717292,2717315,2022-08-04_12-54-08-970247,2717319,23,
2722413,2722437,2022-08-04_12-54-14-218566,2722441,24,
2727560,2727600,2022-08-04_12-54-19-504931,2727604,40,
2732667,2732694,2022-08-04_12-54-24-727232,2732697,27,
2737772,2742885,2022-08-04_12-54-30-050415,2742895,5113,
2742918,2742978,2022-08-04_12-54-35-272293,2742981,60,
2748001,2748081,2022-08-04_12-54-40-496041,2748084,80,
2753156,2753180,2022-08-04_12-54-45-724715,2753183,24,
2758263,2758288,2022-08-04_12-54-50-959625,2758292,25,
2763421,2763467,2022-08-04_12-54-56-266511,2763471,46,
2768528,2768557,2022-08-04_12-55-01-486794,2768561,29,
2773632,2773656,2022-08-04_12-55-06-710831,2773660,24,
2778755,2778781,2022-08-04_12-55-11-961482,2778785,26,
2783885,2783909,2022-08-04_12-55-17-220552,2783915,24,
2789002,2789047,2022-08-04_12-55-22-481075,2789050,45,
2794125,2794150,2022-08-04_12-55-27-713444,2794153,25,
2799290,2799316,2022-08-04_12-55-33-011998,2799320,26,
2804436,2804473,2022-08-04_12-55-38-284238,2804476,37,
2809552,2809577,2022-08-04_12-55-43-527498,2809582,25,
2814718,2814741,2022-08-04_12-55-48-817876,2814745,23,
2819892,2819916,2022-08-04_12-55-54-121937,2819920,24,
2824990,2825111,2022-08-04_12-55-59-446131,2830142,121,
2830155,2830178,2022-08-04_12-56-04-643043,2830181,23,
2835264,2835295,2022-08-04_12-56-09-884433,2835299,31,
2840373,2840398,2022-08-04_12-56-15-114220,2840401,25,
2845543,2845598,2022-08-04_12-56-20-442063,2845600,55,
2850678,2850703,2022-08-04_12-56-25-671292,2850707,25,
2855783,2855808,2022-08-04_12-56-30-901668,2855811,25,
2860892,2860915,2022-08-04_12-56-36-140346,2860919,23,
2866000,2866077,2022-08-04_12-56-41-430451,2866080,77,
2871130,2871153,2022-08-04_12-56-46-630205,2871156,23,
2876231,2876260,2022-08-04_12-56-51-859910,2876264,29,
2881369,2881392,2022-08-04_12-56-57-127775,2881396,23,
2886487,2886562,2022-08-04_12-57-02-423008,2886565,75,
2891628,2891657,2022-08-04_12-57-07-644039,2891661,29,
2896731,2896768,2022-08-04_12-57-12-883229,2896771,37,
2901858,2901881,2022-08-04_12-57-18-125620,2901885,23,
2906966,2906989,2022-08-04_12-57-23-360901,2906992,23,
2912080,2912137,2022-08-04_12-57-28-636240,2912140,57,
2917191,2917237,2022-08-04_12-57-33-862756,2917240,46,
2922305,2922328,2022-08-04_12-57-39-083264,2922331,23,
2927409,2927433,2022-08-04_12-57-44-311411,2927436,24,
2932558,2932589,2022-08-04_12-57-49-597564,2932592,31,
2937672,2937714,2022-08-04_12-57-54-851724,2937717,42,
2942803,2942835,2022-08-04_12-58-00-092192,2942838,32,
2947969,2948018,2022-08-04_12-58-05-400941,2948023,49,
2953073,2953097,2022-08-04_12-58-10-613264,2953100,24,
2958180,2958305,2022-08-04_12-58-15-946815,2963283,125,
2963296,2963319,2022-08-04_12-58-21-092630,2963323,23,
2968397,2968423,2022-08-04_12-58-26-319857,2968426,26,
2973503,2973530,2022-08-04_12-58-31-552922,2973534,27,
2978619,2978683,2022-08-04_12-58-36-837144,2978686,64,
2983727,2983780,2022-08-04_12-58-42-061554,2983783,53,
2988853,2988878,2022-08-04_12-58-47-287306,2988882,25,
2993955,2993983,2022-08-04_12-58-52-520150,2993987,28,
2999063,2999085,2022-08-04_12-58-57-750811,2999089,22,
3004228,3004285,2022-08-04_12-59-03-059007,3004291,57,
3009337,3009360,2022-08-04_12-59-08-280947,3009364,23,
3014487,3014510,2022-08-04_12-59-13-561413,3014513,23,
3019609,3019645,2022-08-04_12-59-18-822413,3019648,36,
3024717,3024746,2022-08-04_12-59-24-050592,3024750,29,
3029821,3029846,2022-08-04_12-59-29-278346,3029850,25,
3034977,3035000,2022-08-04_12-59-34-561382,3035004,23,
3040105,3040132,2022-08-04_12-59-39-817041,3040137,27,
3045266,3045323,2022-08-04_12-59-45-139832,3045326,57,
3050411,3050436,2022-08-04_12-59-50-381282,3050440,25,
3055560,3055583,2022-08-04_12-59-55-660110,3055587,23,
3060675,3060715,2022-08-04_13-00-00-909424,3060718,40,
3065784,3065809,2022-08-04_13-00-06-131656,3065812,25,
3070924,3070948,2022-08-04_13-00-11-405042,3070952,24,
3076041,3076090,2022-08-04_13-00-16-676232,3076095,49,
3081142,3081165,2022-08-04_13-00-21-877754,3081169,23,
3086300,3086329,2022-08-04_13-00-27-162877,3086332,29,
3091455,3091484,2022-08-04_13-00-32-448859,3091487,29,
3096559,3096591,2022-08-04_13-00-37-676597,3096599,32,
3101652,3101681,2022-08-04_13-00-42-898039,3101684,29,
3106807,3106835,2022-08-04_13-00-48-183508,3106839,28,
3111964,3112001,2022-08-04_13-00-53-475600,3112004,37,
3117132,3117183,2022-08-04_13-00-58-787078,3117186,51,
3122237,3122260,2022-08-04_13-01-03-991828,3122264,23,
3127338,3127377,2022-08-04_13-01-09-239608,3127380,39,
3132499,3132524,2022-08-04_13-01-14-514652,3132527,25,
3137642,3137666,2022-08-04_13-01-19-782921,3137669,24,
3142778,3142800,2022-08-04_13-01-25-043823,3142804,22,
3147938,3147962,2022-08-04_13-01-30-332098,3147966,24,
3153055,3153081,2022-08-04_13-01-35-576475,3153084,26,
3158164,3158225,2022-08-04_13-01-40-850423,3158228,61,
3163311,3163336,2022-08-04_13-01-46-086227,3163340,25,
3168467,3168502,2022-08-04_13-01-51-385609,3168505,35,
3173619,3173643,2022-08-04_13-01-56-655650,3173647,24,
3178744,3178768,2022-08-04_13-02-01-905451,3178771,24,
3183897,3183922,2022-08-04_13-02-07-184712,3183925,25,
3189063,3189087,2022-08-04_13-02-12-481746,3189090,24,
3194217,3194250,2022-08-04_13-02-17-766997,3194253,33,
3199325,3199349,2022-08-04_13-02-23-001609,3199353,24,
3204444,3204469,2022-08-04_13-02-28-244279,3204472,25,
3209589,3209615,2022-08-04_13-02-33-519908,3209618,26,
3214716,3214741,2022-08-04_13-02-38-773854,3214744,25,
3219868,3219900,2022-08-04_13-02-44-058002,3219903,32,
3225019,3225043,2022-08-04_13-02-49-333054,3225046,24,
3230168,3230194,2022-08-04_13-02-54-609348,3230197,26,
3235276,3235308,2022-08-04_13-02-59-847740,3235311,32,
3240383,3240407,2022-08-04_13-03-05-079077,3240410,24,
3245492,3245516,2022-08-04_13-03-10-313446,3245520,24,
3250601,3250626,2022-08-04_13-03-15-554558,3250630,25,
3255846,3255871,2022-08-04_13-03-20-927518,3255875,25,
3260952,3260977,2022-08-04_13-03-26-158895,3260981,25,
3266102,3266126,2022-08-04_13-03-31-437064,3266129,24,
3271210,3271234,2022-08-04_13-03-36-673180,3271237,24,
3276321,3276345,2022-08-04_13-03-41-912877,3276348,24,
3281428,3281450,2022-08-04_13-03-47-147124,3281461,22,
3286591,3286616,2022-08-04_13-03-52-437446,3286619,25,
3291712,3291736,2022-08-04_13-03-57-687731,3291739,24,
3296820,3296846,2022-08-04_13-04-02-923777,3296849,26,
3301943,3301968,2022-08-04_13-04-08-173868,3301971,25,
3307050,3307074,2022-08-04_13-04-13-407849,3307078,24,
3312162,3312187,2022-08-04_13-04-18-649976,3312191,25,
3317267,3317292,2022-08-04_13-04-23-878980,3317295,25,
3322415,3322438,2022-08-04_13-04-29-154985,3322441,23,
3327522,3327556,2022-08-04_13-04-34-401026,3327559,34,
3332631,3332657,2022-08-04_13-04-39-625474,3332661,26,
3337738,3337763,2022-08-04_13-04-44-858966,3337766,25,
3342846,3342882,2022-08-04_13-04-50-107062,3342885,36,
3347955,3347980,2022-08-04_13-04-55-332615,3347983,25,
3353063,3353087,2022-08-04_13-05-00-566284,3353090,24,
3358218,3358248,2022-08-04_13-05-05-851036,3358251,30,
3363345,3363376,2022-08-04_13-05-11-111042,3363386,31,
3368451,3368476,2022-08-04_13-05-16-338419,3368479,25,
3373560,3373583,2022-08-04_13-05-21-569498,3373586,23,
3378670,3378693,2022-08-04_13-05-26-810292,3378697,23,
3383781,3383805,2022-08-04_13-05-32-050627,3383808,24,
3388887,3388909,2022-08-04_13-05-37-279784,3388912,22,
3394003,3394027,2022-08-04_13-05-42-524555,3394030,24,
3399111,3399145,2022-08-04_13-05-47-774234,3399148,34,
3404219,3404246,2022-08-04_13-05-52-999830,3404250,27,
3409375,3409402,2022-08-04_13-05-58-281963,3409405,27,
3414531,3414555,2022-08-04_13-06-03-565138,3414558,24,
3419632,3419660,2022-08-04_13-06-08-794904,3419663,28,
3424739,3424766,2022-08-04_13-06-14-026300,3424769,27,
3429887,3429912,2022-08-04_13-06-19-305393,3429915,25,
3435033,3435059,2022-08-04_13-06-24-581495,3435062,26,
3440183,3440206,2022-08-04_13-06-29-857211,3440210,23,
3445331,3445355,2022-08-04_13-06-35-132945,3445358,24,
3450439,3450466,2022-08-04_13-06-40-369307,3450469,27,
3455583,3455615,2022-08-04_13-06-45-639615,3455618,32,
3460734,3460758,2022-08-04_13-06-50-920117,3460761,24,
3465882,3465906,2022-08-04_13-06-56-197812,3465909,24,
3471036,3471060,2022-08-04_13-07-01-479388,3471063,24,
3476176,3476222,2022-08-04_13-07-06-750802,3476225,46,
3481320,3481346,2022-08-04_13-07-12-018990,3481349,26,
3486453,3486496,2022-08-04_13-07-17-287084,3486499,43,
3491557,3491583,2022-08-04_13-07-22-508332,3491586,26,
3496701,3496726,2022-08-04_13-07-27-779591,3496729,25,
3501834,3501857,2022-08-04_13-07-33-041410,3501860,23,
3506994,3507020,2022-08-04_13-07-38-331943,3507024,26,
3512139,3512167,2022-08-04_13-07-43-603460,3512170,28,
3517271,3517296,2022-08-04_13-07-48-864451,3517299,25,
3522407,3522450,2022-08-04_13-07-54-128399,3522454,43,
3527534,3527558,2022-08-04_13-07-59-382243,3527561,24,
3532645,3532671,2022-08-04_13-08-04-621574,3532675,26,
3537781,3537806,2022-08-04_13-08-09-883264,3537809,25,
3542913,3542937,2022-08-04_13-08-15-144613,3542941,24,
3548058,3548083,2022-08-04_13-08-20-420890,3548086,25,
3553188,3553218,2022-08-04_13-08-25-674701,3553221,30,
3558311,3558336,2022-08-04_13-08-30-926523,3558339,25,
3563462,3563485,2022-08-04_13-08-36-208233,3563488,23,
3568604,3568627,2022-08-04_13-08-41-477635,3568631,23,
3573712,3573734,2022-08-04_13-08-46-710568,3573737,22,
3578818,3578841,2022-08-04_13-08-51-947250,3578845,23,
3583971,3583996,2022-08-04_13-08-57-228668,3583999,25,
3589122,3589147,2022-08-04_13-09-02-507657,3589150,25,
3594253,3594278,2022-08-04_13-09-07-767104,3594282,25,
3599366,3599390,2022-08-04_13-09-13-005885,3599393,24,
3604472,3604498,2022-08-04_13-09-18-239797,3604501,26,
3609611,3609635,2022-08-04_13-09-23-507343,3609638,24,
3614765,3614787,2022-08-04_13-09-28-786182,3614791,22,
3619918,3619942,2022-08-04_13-09-34-067113,3619946,24,
3625049,3625072,2022-08-04_13-09-39-327668,3625076,23,
3630189,3630216,2022-08-04_13-09-44-596069,3630219,27,
3635306,3635329,2022-08-04_13-09-49-839534,3635333,23,
3640462,3640488,2022-08-04_13-09-55-122422,3640491,26,
3645570,3645594,2022-08-04_13-10-00-362140,3645597,24,
3650678,3650702,2022-08-04_13-10-05-595844,3650705,24,
3655785,3655809,2022-08-04_13-10-10-826512,3655812,24,
3660893,3660916,2022-08-04_13-10-16-067495,3660919,23,
3666002,3666028,2022-08-04_13-10-21-303606,3666031,26,
3671123,3671146,2022-08-04_13-10-26-550395,3671149,23,
3676229,3676253,2022-08-04_13-10-31-782568,3676257,24,
3681373,3681398,2022-08-04_13-10-37-055338,3681402,25,
3686480,3686504,2022-08-04_13-10-42-293037,3686507,24,
3691625,3691650,2022-08-04_13-10-47-562149,3691654,25,
3696732,3696756,2022-08-04_13-10-52-797117,3696760,24,
3701846,3701888,2022-08-04_13-10-58-060015,3701892,42,
3706972,3706996,2022-08-04_13-11-03-296537,3706999,24,
3712078,3712114,2022-08-04_13-11-08-534317,3712118,36,
3717186,3717210,2022-08-04_13-11-13-761873,3717214,24,
3722336,3722359,2022-08-04_13-11-19-040848,3722362,23,
3727452,3727475,2022-08-04_13-11-24-283680,3727480,23,
3732600,3732624,2022-08-04_13-11-29-557871,3732628,24,
3737720,3737769,2022-08-04_13-11-34-829709,3737773,49,
3742825,3742850,2022-08-04_13-11-40-040460,3742854,25,
3747971,3747996,2022-08-04_13-11-45-311966,3747999,25,
3753081,3753106,2022-08-04_13-11-50-550573,3753109,25,
3758188,3758213,2022-08-04_13-11-55-785333,3758217,25,
3763346,3763369,2022-08-04_13-12-01-071848,3763372,23,
3768454,3768480,2022-08-04_13-12-06-308406,3768483,26,
3773572,3773597,2022-08-04_13-12-11-552086,3773600,25,
3778686,3778709,2022-08-04_13-12-16-795770,3778713,23,
3783800,3783824,2022-08-04_13-12-22-037300,3783827,24,
3788903,3788927,2022-08-04_13-12-27-264004,3788930,24,
3794059,3794084,2022-08-04_13-12-32-549837,3794087,25,
3799167,3799213,2022-08-04_13-12-37-810589,3799216,46,
3804274,3804299,2022-08-04_13-12-43-021123,3804303,25,
3809430,3809455,2022-08-04_13-12-48-305195,3809459,25,
3814537,3814561,2022-08-04_13-12-53-537825,3814565,24,
3819644,3819668,2022-08-04_13-12-58-773919,3819671,24,
3824790,3824812,2022-08-04_13-13-04-047117,3824816,22,
3829898,3829921,2022-08-04_13-13-09-280789,3829924,23,
3835041,3835064,2022-08-04_13-13-14-552221,3835068,23,
3840155,3840179,2022-08-04_13-13-19-794713,3840182,24,
3845269,3845293,2022-08-04_13-13-25-033938,3845296,24,
3850408,3850432,2022-08-04_13-13-30-303325,3850435,24,
3855532,3855560,2022-08-04_13-13-35-558837,3855563,28,
3860663,3860707,2022-08-04_13-13-40-824610,3860711,44,
3865808,3865833,2022-08-04_13-13-46-089246,3865836,25,
3870945,3870971,2022-08-04_13-13-51-354765,3870974,26,
3876054,3876078,2022-08-04_13-13-56-592422,3876087,24,
3881179,3881216,2022-08-04_13-14-01-847641,3881219,37,
3886325,3886348,2022-08-04_13-14-07-117885,3886352,23,
3891459,3891483,2022-08-04_13-14-12-379938,3891487,24,
3896593,3896618,2022-08-04_13-14-17-641605,3896621,25,
3901729,3901758,2022-08-04_13-14-22-908959,3901762,29,
3906838,3906866,2022-08-04_13-14-28-144067,3906869,28,
3911945,3911970,2022-08-04_13-14-33-375169,3911973,25,
3917091,3917114,2022-08-04_13-14-38-648202,3917118,23,
3922233,3922257,2022-08-04_13-14-43-915407,3922260,24,
3927385,3927409,2022-08-04_13-14-49-197138,3927414,24,
3932505,3932529,2022-08-04_13-14-54-443580,3932532,24,
3937632,3937655,2022-08-04_13-14-59-699288,3937658,23,
3942765,3942788,2022-08-04_13-15-04-959362,3942791,23,
3947904,3947932,2022-08-04_13-15-10-228995,3947935,28,
3953011,3953035,2022-08-04_13-15-15-460805,3953038,24,
3958119,3958223,2022-08-04_13-15-20-771876,3958226,104,
3963279,3963324,2022-08-04_13-15-26-001439,3963328,45,
3968379,3968407,2022-08-04_13-15-31-208655,3968410,28,
3973487,3973516,2022-08-04_13-15-36-447117,3973519,29,
3978631,3978653,2022-08-04_13-15-41-711766,3978657,22,
3983783,3983808,2022-08-04_13-15-46-993347,3983811,25,
3988889,3988927,2022-08-04_13-15-52-225833,3988933,38,
3994006,3994089,2022-08-04_13-15-57-531309,3994092,83,
3999110,3999194,2022-08-04_13-16-02-764222,3999198,84,
4004220,4004288,2022-08-04_13-16-07-986794,4004291,68,
4009323,4009346,2022-08-04_13-16-13-171088,4009350,23,
4014465,4014495,2022-08-04_13-16-18-446936,4014500,30,
4019631,4019679,2022-08-04_13-16-23-756685,4019682,48,
4024745,4024773,2022-08-04_13-16-28-977538,4024776,28,
4029853,4029883,2022-08-04_13-16-34-212534,4029886,30,
4034958,4035061,2022-08-04_13-16-39-526913,4035064,103,
4040059,4040082,2022-08-04_13-16-44-669504,4040086,23,
4045188,4045238,2022-08-04_13-16-49-955872,4045242,50,
4050325,4050351,2022-08-04_13-16-55-196054,4050355,26,
4055436,4055550,2022-08-04_13-17-00-522689,4060543,114,
4060559,4065650,2022-08-04_13-17-05-844006,4065653,5091,
4065654,4065693,2022-08-04_13-17-10-917718,4065697,39,
4070770,4070855,2022-08-04_13-17-16-205563,4070859,85,
4075877,4075901,2022-08-04_13-17-21-384895,4075904,24,
4080990,4081018,2022-08-04_13-17-26-627488,4081022,28,
4086094,4086214,2022-08-04_13-17-31-954413,4091241,120,
4091259,4091309,2022-08-04_13-17-37-175618,4091312,50,
4096359,4096383,2022-08-04_13-17-42-374629,4096386,24,
4101491,4101516,2022-08-04_13-17-47-635138,4101520,25,
4106589,4106630,2022-08-04_13-17-52-879405,4106633,41,
4111696,4111719,2022-08-04_13-17-58-093183,4111722,23,
4116806,4116831,2022-08-04_13-18-03-333046,4116835,25,
4121918,4121943,2022-08-04_13-18-08-574121,4121946,25,
4127034,4127080,2022-08-04_13-18-13-839251,4127083,46,
4132142,4137248,2022-08-04_13-18-19-056745,4137259,5106,
4137272,4137319,2022-08-04_13-18-24-307648,4137322,47,
4142360,4142391,2022-08-04_13-18-29-524357,4142394,31,
4147468,4147514,2022-08-04_13-18-34-761967,4147518,46,
4152575,4152665,2022-08-04_13-18-40-049972,4152668,90,
4157705,4157729,2022-08-04_13-18-45-249256,4157732,24,
4162824,4162850,2022-08-04_13-18-50-496182,4162854,26,
4167925,4168049,2022-08-04_13-18-55-819455,4173019,124,
4173019,4173043,2022-08-04_13-19-00-942118,4173046,24,
4178194,4178234,2022-08-04_13-19-06-259460,4178238,40,
4183338,4183431,2022-08-04_13-19-11-589613,4183434,93,
4188475,4188498,2022-08-04_13-19-16-783802,4188502,23,
4193582,4193609,2022-08-04_13-19-22-018348,4193612,27,
4198734,4198758,2022-08-04_13-19-27-298057,4198761,24,
4203847,4203872,2022-08-04_13-19-32-538183,4203875,25,
4209006,4209031,2022-08-04_13-19-37-825295,4209034,25,
4214115,4214139,2022-08-04_13-19-43-063831,4214143,24,
4219244,4219287,2022-08-04_13-19-48-339032,4219290,43,
4224357,4224383,2022-08-04_13-19-53-560441,4224387,26,
4229458,4229485,2022-08-04_13-19-58-788682,4229488,27,