RD,TS_received,TS_sent,AK,RoundTrip,
97921,97946,2022-07-28_18-08-57-150614,97949,25,
103030,103053,2022-07-28_18-09-02-384511,103056,23,
108148,108237,2022-07-28_18-09-07-678658,108240,89,
113301,113324,2022-07-28_18-09-12-904816,113327,23,
118410,118434,2022-07-28_18-09-18-136105,118437,24,
123517,123543,2022-07-28_18-09-23-368441,123547,26,
128626,128654,2022-07-28_18-09-28-605137,128664,28,
133734,133758,2022-07-28_18-09-33-835494,133761,24,
138842,138869,2022-07-28_18-09-39-066250,138873,27,
143950,143973,2022-07-28_18-09-44-299706,143976,23,
149057,149080,2022-07-28_18-09-49-529793,149083,23,
154166,154189,2022-07-28_18-09-54-763657,154192,23,
159276,159300,2022-07-28_18-09-59-996705,159303,24,
164381,164405,2022-07-28_18-10-05-229157,164409,24,
169490,169522,2022-07-28_18-10-10-464782,169525,32,
174598,174623,2022-07-28_18-10-15-686434,174627,25,
179752,179776,2022-07-28_18-10-20-966467,179780,24,
184860,184884,2022-07-28_18-10-26-196603,184887,24,
189968,189997,2022-07-28_18-10-31-429769,190000,29,
195076,195099,2022-07-28_18-10-36-659247,195102,23,
200235,200283,2022-07-28_18-10-41-955271,200286,48,
205383,205407,2022-07-28_18-10-47-217905,205411,24,
210490,210514,2022-07-28_18-10-52-451268,210517,24,
215598,215624,2022-07-28_18-10-57-683061,215627,26,
220769,220793,2022-07-28_18-11-02-976339,220797,24,
225929,225955,2022-07-28_18-11-08-258502,225958,26,
231037,231060,2022-07-28_18-11-13-490077,231063,23,
236182,236206,2022-07-28_18-11-18-760910,236211,24,
241311,241335,2022-07-28_18-11-24-013578,241338,24,
246470,246493,2022-07-28_18-11-29-298520,246497,23,
251577,251600,2022-07-28_18-11-34-527673,251605,23,
256728,256755,2022-07-28_18-11-39-801803,256758,27,
261855,261880,2022-07-28_18-11-45-052961,261884,25,
266963,266986,2022-07-28_18-11-50-282646,266989,23,
272070,272097,2022-07-28_18-11-55-512560,272100,27,
277215,277237,2022-07-28_18-12-00-786786,277240,22,
282361,282387,2022-07-28_18-12-06-059668,282389,26,
287512,287540,2022-07-28_18-12-11-332670,287543,28,
292654,292681,2022-07-28_18-12-16-598367,292684,27,
297789,297814,2022-07-28_18-12-21-856301,297819,25,
302940,302964,2022-07-28_18-12-27-133699,302967,24,
308084,308111,2022-07-28_18-12-32-406292,308114,27,
313192,313217,2022-07-28_18-12-37-632580,313220,25,
318348,318374,2022-07-28_18-12-42-917801,318377,26,
323501,323526,2022-07-28_18-12-48-193207,323529,25,
328639,328666,2022-07-28_18-12-53-458315,328670,27,
333763,333786,2022-07-28_18-12-58-699895,333790,23,
338871,338890,2022-07-28_18-13-03-931746,338899,19,
344032,344077,2022-07-28_18-13-09-236754,344081,45,
349140,349168,2022-07-28_18-13-14-448245,349171,28,
354284,354307,2022-07-28_18-13-19-714854,354311,23,
359421,359446,2022-07-28_18-13-24-978207,359449,25,
364572,364597,2022-07-28_18-13-30-251951,364600,25,
369717,369745,2022-07-28_18-13-35-522510,369748,28,
374862,374888,2022-07-28_18-13-40-784905,374891,26,
380017,380044,2022-07-28_18-13-46-069655,380048,27,
385123,385149,2022-07-28_18-13-51-300054,385153,26,
390246,395374,2022-07-28_18-13-56-546259,395383,5128,
395398,395425,2022-07-28_18-14-01-822423,395429,27,
400488,400511,2022-07-28_18-14-07-039032,400514,23,
405622,405649,2022-07-28_18-14-12-296179,405653,27,
410759,410782,2022-07-28_18-14-17-556965,410785,23,
415865,415889,2022-07-28_18-14-22-786980,415892,24,
420973,420996,2022-07-28_18-14-28-017866,421000,23,
426130,426155,2022-07-28_18-14-33-299186,426158,25,
431290,431315,2022-07-28_18-14-38-583279,431318,25,
436426,436456,2022-07-28_18-14-43-846763,436459,30,
441534,441562,2022-07-28_18-14-49-075485,441565,28,
446686,446710,2022-07-28_18-14-54-354254,446714,24,
451793,451818,2022-07-28_18-14-59-582168,451821,25,
456903,456926,2022-07-28_18-15-04-813273,456935,23,
462009,462031,2022-07-28_18-15-10-043387,462034,22,
467118,467142,2022-07-28_18-15-15-275510,467146,24,
472228,472254,2022-07-28_18-15-20-512468,472257,26,
477340,477370,2022-07-28_18-15-25-756206,477373,30,
482509,482533,2022-07-28_18-15-31-042355,482536,24,
487622,487648,2022-07-28_18-15-36-278417,487652,26,
492730,492753,2022-07-28_18-15-41-509404,492758,23,
497890,497921,2022-07-28_18-15-46-798770,497924,31,
503002,503027,2022-07-28_18-15-52-029931,503030,25,
508109,508135,2022-07-28_18-15-57-261459,508138,26,
513269,513295,2022-07-28_18-16-02-544438,513298,26,
518378,518401,2022-07-28_18-16-07-781679,518404,23,
523535,523578,2022-07-28_18-16-13-061586,523581,43,
528642,528666,2022-07-28_18-16-18-292903,528669,24,
533751,533775,2022-07-28_18-16-23-525821,533779,24,
538901,538926,2022-07-28_18-16-28-799988,538929,25,
544008,544034,2022-07-28_18-16-34-028306,544037,26,
549123,549146,2022-07-28_18-16-39-264585,549150,23,
554225,554250,2022-07-28_18-16-44-491871,554253,25,
559343,559367,2022-07-28_18-16-49-730218,559370,24,
564450,564472,2022-07-28_18-16-54-960720,564475,22,
569571,569594,2022-07-28_18-17-00-209017,569597,23,
574676,574701,2022-07-28_18-17-05-435255,574704,25,
579784,579808,2022-07-28_18-17-10-665824,579811,24,
584940,584968,2022-07-28_18-17-15-949876,584972,28,
590049,590073,2022-07-28_18-17-21-180699,590076,24,
595156,595181,2022-07-28_18-17-26-411718,595184,25,
600265,600289,2022-07-28_18-17-31-645508,600292,24,
605388,605428,2022-07-28_18-17-36-903544,605436,40,
610493,610517,2022-07-28_18-17-42-118910,610521,24,
615602,615630,2022-07-28_18-17-47-353078,615633,28,
620709,625873,2022-07-28_18-17-52-772574,625881,5164,
625881,625921,2022-07-28_18-17-57-895862,625925,40,
630987,631016,2022-07-28_18-18-03-115298,631020,29,
636095,636119,2022-07-28_18-18-08-340933,636122,24,
641208,641243,2022-07-28_18-18-13-573604,641250,35,
646391,646415,2022-07-28_18-18-18-889034,646419,24,
651553,651615,2022-07-28_18-18-24-214315,651618,62,
656685,656722,2022-07-28_18-18-29-437723,656727,37,
661872,661908,2022-07-28_18-18-34-752892,661912,36,
666982,667009,2022-07-28_18-18-39-981898,667012,27,
672089,672210,2022-07-28_18-18-45-305115,677195,121,
677208,677232,2022-07-28_18-18-50-449947,677236,24,
682321,682345,2022-07-28_18-18-55-688997,682348,24,
687433,687509,2022-07-28_18-19-00-971415,687515,76,
692593,692631,2022-07-28_18-19-06-209741,692635,38,
697701,697799,2022-07-28_18-19-11-514029,697802,98,
702810,702834,2022-07-28_18-19-16-670987,702837,24,
707968,707998,2022-07-28_18-19-21-959336,708002,30,
713074,713102,2022-07-28_18-19-27-183240,713105,28,
718183,723337,2022-07-28_18-19-32-511502,723354,5154,
723376,723406,2022-07-28_18-19-37-736223,723410,30,
728442,728469,2022-07-28_18-19-42-921709,728472,27,
733585,
738687,738711,2022-07-28_18-19-53-413917,738714,24,
743869,743898,2022-07-28_18-19-58-729000,743902,29,
748976,754076,2022-07-28_18-20-04-052112,754087,5100,
754100,754125,2022-07-28_18-20-09-198493,754128,25,
759193,759217,2022-07-28_18-20-14-416315,759220,24,
764300,764324,2022-07-28_18-20-19-646869,764327,24,
769408,769491,2022-07-28_18-20-24-940503,769494,83,
774548,774600,2022-07-28_18-20-30-166673,774604,52,
779657,779693,2022-07-28_18-20-35-387664,779697,36,
784764,784790,2022-07-28_18-20-40-607412,784793,26,
789871,789992,2022-07-28_18-20-45-934574,794970,121,
794993,795091,2022-07-28_18-20-51-157392,795094,98,
800080,805233,2022-07-28_18-20-56-482016,805239,5153,
805239,805293,2022-07-28_18-21-01-603519,805296,54,
810345,810393,2022-07-28_18-21-06-825132,810397,48,
815456,815488,2022-07-28_18-21-12-044133,815492,32,
820562,825658,2022-07-28_18-21-17-468842,825661,5096,
825662,825687,2022-07-28_18-21-22-491350,825690,25,
830817,830889,2022-07-28_18-21-27-816776,830893,72,
835922,835988,2022-07-28_18-21-33-039186,835992,66,
841076,841178,2022-07-28_18-21-38-354079,841181,102,
846217,846291,2022-07-28_18-21-43-590129,846294,74,
851347,851386,2022-07-28_18-21-48-810405,851389,39,
856453,856485,2022-07-28_18-21-54-035040,856488,32,
861562,861590,2022-07-28_18-21-59-256309,861596,28,
866670,866695,2022-07-28_18-22-04-488348,866698,25,
871776,871798,2022-07-28_18-22-09-717001,871802,22,
876921,876943,2022-07-28_18-22-14-986957,876947,22,
882050,882083,2022-07-28_18-22-20-249282,882086,33,
887155,892255,2022-07-28_18-22-25-567854,892272,5100,
892294,892382,2022-07-28_18-22-30-793101,892389,88,
897363,897405,2022-07-28_18-22-35-925820,897410,42,
902480,902530,2022-07-28_18-22-41-160960,902534,50,
907602,907678,2022-07-28_18-22-46-458400,907681,76,
912734,912758,2022-07-28_18-22-51-662767,912761,24,
917841,917877,2022-07-28_18-22-56-903318,917880,36,
922956,928102,2022-07-28_18-23-02-161849,928107,5146,
928107,928178,2022-07-28_18-23-07-454740,928184,71,
933230,933268,2022-07-28_18-23-12-668670,933271,38,
938338,938373,2022-07-28_18-23-17-897282,938377,35,
943453,943479,2022-07-28_18-23-23-124037,943482,26,
948560,948585,2022-07-28_18-23-28-358009,948588,25,
953668,953696,2022-07-28_18-23-33-586625,953699,28,
958783,958863,2022-07-28_18-23-38-882293,958868,80,
963942,963968,2022-07-28_18-23-44-109339,963971,26,
969116,969165,2022-07-28_18-23-49-430870,969169,49,
974246,974269,2022-07-28_18-23-54-659994,974273,23,
979369,979392,2022-07-28_18-23-59-908050,979396,23,
984520,984563,2022-07-28_18-24-05-201000,984566,43,
989629,989670,2022-07-28_18-24-10-431553,989676,41,
994730,994754,2022-07-28_18-24-15-643277,994758,24,
999842,1004946,2022-07-28_18-24-20-974380,1004957,5104,
1004971,1004995,2022-07-28_18-24-26-128671,1004998,24,
1010058,1010159,2022-07-28_18-24-31-413750,1010162,101,
1015202,
1020331,1025495,2022-07-28_18-24-42-012671,1025501,5164,
1025502,1025557,2022-07-28_18-24-47-191212,1025560,55,
1030621,1030650,2022-07-28_18-24-52-406684,1030654,29,
1035814,1035857,2022-07-28_18-24-57-739081,1035861,43,
1040946,1040971,2022-07-28_18-25-02-976446,1040974,25,
1046104,1046159,2022-07-28_18-25-08-286923,1046165,55,
1051245,1051348,2022-07-28_18-25-13-603105,1051352,103,
1056419,1056443,2022-07-28_18-25-18-824431,1056446,24,
1061523,1061562,2022-07-28_18-25-24-064191,1061565,39,
1066630,1066654,2022-07-28_18-25-29-282225,1066657,24,
1071769,1071851,2022-07-28_18-25-34-600496,1071856,82,
1076901,1076927,2022-07-28_18-25-39-802761,1076930,26,
1082025,1082052,2022-07-28_18-25-45-050953,1082055,27,
1087181,1087244,2022-07-28_18-25-50-365515,1087246,63,
1092321,1092345,2022-07-28_18-25-55-593858,1092349,24,
1097453,1097476,2022-07-28_18-26-00-846421,1097480,23,
1102597,1102645,2022-07-28_18-26-06-142188,1102648,48,
1107716,1107742,2022-07-28_18-26-11-364638,1107745,26,
1112822,1112844,2022-07-28_18-26-16-594119,1112847,22,
1117970,1117996,2022-07-28_18-26-21-862263,1117999,26,
1123124,1128261,2022-07-28_18-26-27-337375,1128264,5137,
1128264,1128290,2022-07-28_18-26-32-405949,1128293,26,
1133407,1133444,2022-07-28_18-26-37-682519,1133450,37,
1138511,1138538,2022-07-28_18-26-42-901032,1138541,27,
1143651,1143675,2022-07-28_18-26-48-164942,1143678,24,
1148814,1148837,2022-07-28_18-26-53-452083,1148840,23,
1153915,1153939,2022-07-28_18-26-58-672847,1153942,24,
1159078,1159147,2022-07-28_18-27-04-001238,1159153,69,
1164184,1164237,2022-07-28_18-27-09-218958,1164240,53,
1169295,1169344,2022-07-28_18-27-14-445084,1169350,49,
1174401,1174439,2022-07-28_18-27-19-666939,1174445,38,
1179510,1184609,2022-07-28_18-27-24-997986,1184618,5099,
1184632,1184656,2022-07-28_18-27-30-134731,1184659,24,
1189720,1189747,2022-07-28_18-27-35-345234,1189750,27,
1194881,1194928,2022-07-28_18-27-40-644911,1194931,47,
1199989,1200037,2022-07-28_18-27-45-881460,1200042,48,
1205106,1205131,2022-07-28_18-27-51-108149,1205134,25,
1210220,1210339,2022-07-28_18-27-56-426188,1215316,119,
1215335,1215422,2022-07-28_18-28-01-642858,1215425,87,
1220430,1220464,2022-07-28_18-28-06-805240,1220467,34,
1225537,1225632,2022-07-28_18-28-12-094609,1225638,95,
1230651,1230724,2022-07-28_18-28-17-315919,1230729,73,
1235751,1235775,2022-07-28_18-28-22-491499,1235779,24,
1240903,1240940,2022-07-28_18-28-27-770536,1240943,37,
1246030,1246069,2022-07-28_18-28-33-026766,1246072,39,
1251148,1251226,2022-07-28_18-28-38-309894,1251231,78,
1256267,1261434,2022-07-28_18-28-43-652256,1261439,5167,
1261440,1261520,2022-07-28_18-28-48-857710,1261525,80,
1266542,1266620,2022-07-28_18-28-54-080257,1266623,78,
1271699,1271737,2022-07-28_18-28-59-309806,1271742,38,
1276816,1276840,2022-07-28_18-29-04-550841,1276844,24,
1281930,1281955,2022-07-28_18-29-09-791356,1281958,25,
1287067,1287120,2022-07-28_18-29-15-074147,1287125,53,
1292186,1292218,2022-07-28_18-29-20-295507,1292224,32,
1297291,1297314,2022-07-28_18-29-25-517829,1297317,23,
1302399,1302422,2022-07-28_18-29-30-748083,1302425,23,
1307506,1307602,2022-07-28_18-29-36-050170,1307605,96,
1312617,1312640,2022-07-28_18-29-41-213768,1312643,23,
1317789,1317814,2022-07-28_18-29-46-514555,1317817,25,
1322897,1328001,2022-07-28_18-29-51-933313,1328004,5104,
1328004,1328031,2022-07-28_18-29-56-974200,1328036,27,
1333124,1333148,2022-07-28_18-30-02-217971,1333151,24,
1338232,1338274,2022-07-28_18-30-07-450956,1338278,42,
1343348,1343374,2022-07-28_18-30-12-686298,1343377,26,
1348457,1348479,2022-07-28_18-30-17-917407,1348482,22,
1353576,1353603,2022-07-28_18-30-23-165230,1353606,27,
1358683,1358709,2022-07-28_18-30-28-392737,1358712,26,
1363791,1363814,2022-07-28_18-30-33-624053,1363818,23,
1368899,1374003,2022-07-28_18-30-39-026534,1374006,5104,
1374007,1374033,2022-07-28_18-30-44-089939,1374036,26,
1379115,1379201,2022-07-28_18-30-49-380464,1379206,86,
1384259,1384301,2022-07-28_18-30-54-606152,1384305,42,
1389369,1389401,2022-07-28_18-30-59-827491,1389404,32,
1394519,1394596,2022-07-28_18-31-05-144840,1394600,77,
1399617,1399642,2022-07-28_18-31-10-316131,1399646,25,
1404734,1404801,2022-07-28_18-31-15-595493,1404806,67,
1409837,1409865,2022-07-28_18-31-20-791574,1409870,28,
1414950,1414994,2022-07-28_18-31-26-036916,1414997,44,
1420076,1420099,2022-07-28_18-31-31-271076,1420103,23,
1425180,1425220,2022-07-28_18-31-36-517692,1425224,40,
1430286,1430313,2022-07-28_18-31-41-730674,1430317,27,
1435447,1435509,2022-07-28_18-31-47-037562,1435515,62,
1440569,1440595,2022-07-28_18-31-52-259108,1440598,26,
1445670,1445705,2022-07-28_18-31-57-499175,1445709,35,
1450778,1455932,2022-07-28_18-32-02-918891,1455935,5154,
1455936,1455959,2022-07-28_18-32-07-999422,1455962,23,
1461053,1461077,2022-07-28_18-32-13-242936,1461080,24,
1466161,1466209,2022-07-28_18-32-18-494471,1466213,48,
1471262,1471286,2022-07-28_18-32-23-701096,1471291,24,
1476367,1476469,2022-07-28_18-32-28-928555,1476476,102,
1481539,1481575,2022-07-28_18-32-34-234222,1481578,36,
1486636,1486697,2022-07-28_18-32-39-470579,1486703,61,
1491808,1491884,2022-07-28_18-32-44-790937,1491887,76,
1496915,1496971,2022-07-28_18-32-50-004300,1496974,56,
1502016,1502079,2022-07-28_18-32-55-231187,1502084,63,
1507131,1512226,2022-07-28_18-33-00-664027,1512230,5095,
1512230,1512255,2022-07-28_18-33-05-657859,1512259,25,
1517382,1517420,2022-07-28_18-33-10-947825,1517424,38,
1522527,1522549,2022-07-28_18-33-16-203634,1522553,22,
1527653,1527690,2022-07-28_18-33-21-457748,1527697,37,
1532799,1532823,2022-07-28_18-33-26-722269,1532826,24,
1537953,1537975,2022-07-28_18-33-32-001491,1537979,22,
1543060,1543086,2022-07-28_18-33-37-234963,1543089,26,
1548168,1548271,2022-07-28_18-33-42-536194,1548275,103,
1553281,1553304,2022-07-28_18-33-47-697480,1553307,23,
1558391,1558478,2022-07-28_18-33-52-985538,1558484,87,
1563510,1563564,2022-07-28_18-33-58-210918,1563567,54,
1568638,1568662,2022-07-28_18-34-03-432952,1568665,24,
1573804,1573850,2022-07-28_18-34-08-744157,1573853,46,
1578911,1578960,2022-07-28_18-34-13-976835,1578964,49,
1584010,1584033,2022-07-28_18-34-19-173016,1584036,23,
1589155,1589179,2022-07-28_18-34-24-441609,1589183,24,
1594268,1594292,2022-07-28_18-34-29-677399,1594296,24,
1599404,1599429,2022-07-28_18-34-34-938778,1599432,25,
1604536,1604559,2022-07-28_18-34-40-194711,1604562,23,
1609693,1609715,2022-07-28_18-34-45-475838,1609718,22,
1614835,1614860,2022-07-28_18-34-50-741903,1614864,25,
1619970,1619994,2022-07-28_18-34-56-003653,1619997,24,
1625131,1625156,2022-07-28_18-35-01-290414,1625159,25,
1630238,1630276,2022-07-28_18-35-06-522034,1630280,38,
1635346,1635370,2022-07-28_18-35-11-748729,1635373,24,
1640507,1640530,2022-07-28_18-35-17-034842,1640533,23,
1645658,1645682,2022-07-28_18-35-22-312960,1645685,24,
1650813,1650837,2022-07-28_18-35-27-589884,1650840,24,
1655920,1655947,2022-07-28_18-35-32-819820,1655950,27,
1661039,1661063,2022-07-28_18-35-38-065361,1661066,24,
1666147,1666177,2022-07-28_18-35-43-300169,1666180,30,
1671299,1671324,2022-07-28_18-35-48-570686,1671327,25,
1676406,1676430,2022-07-28_18-35-53-803072,1676434,24,
1681513,1681541,2022-07-28_18-35-59-035436,1681544,28,
1686623,1686646,2022-07-28_18-36-04-267032,1686649,23,
1691735,1691760,2022-07-28_18-36-09-504684,1691764,25,
1696843,1696870,2022-07-28_18-36-14-736807,1696873,27,
1702013,1707172,2022-07-28_18-36-20-032549,1707182,5159,
1707195,1707238,2022-07-28_18-36-25-358657,1707242,43,
1712309,1712340,2022-07-28_18-36-30-580501,1712343,31,
1717409,1717434,2022-07-28_18-36-35-802114,1717439,25,
1722517,1722542,2022-07-28_18-36-41-029680,1722545,25,
1727673,1727697,2022-07-28_18-36-46-309245,1727700,24,
1732801,1732825,2022-07-28_18-36-51-562428,1732828,24,
1737909,1737937,2022-07-28_18-36-56-796365,1737940,28,
1743016,1743041,2022-07-28_18-37-02-028279,1743045,25,
1748177,1748204,2022-07-28_18-37-07-310842,1748207,27,
1753285,1753308,2022-07-28_18-37-12-544033,1753311,23,
1758393,1758416,2022-07-28_18-37-17-777807,1758420,23,
1763509,1763534,2022-07-28_18-37-23-014622,1763538,25,
1768615,1768638,2022-07-28_18-37-28-247043,1768641,23,
1773723,1773749,2022-07-28_18-37-33-481157,1773752,26,
1778894,1778923,2022-07-28_18-37-38-773369,1778927,29,
1784051,1784077,2022-07-28_18-37-44-051681,1784080,26,
1789158,1789182,2022-07-28_18-37-49-283199,1789186,24,
1794278,1794302,2022-07-28_18-37-54-528105,1794305,24,
1799424,1799449,2022-07-28_18-37-59-799798,1799452,25,
1804531,1804556,2022-07-28_18-38-05-028280,1804559,25,
1809639,1809662,2022-07-28_18-38-10-257231,1809665,23,
1814748,1814771,2022-07-28_18-38-15-494314,1814775,23,
1819855,1819879,2022-07-28_18-38-20-723601,1819883,24,
1824963,1824987,2022-07-28_18-38-25-955269,1824990,24,
1830107,1830131,2022-07-28_18-38-31-223119,1830134,24,
1835215,1835242,2022-07-28_18-38-36-458151,1835245,27,
1840324,1840355,2022-07-28_18-38-41-686796,1840358,31,
1845431,1845454,2022-07-28_18-38-46-917448,1845457,23,
1850539,1850563,2022-07-28_18-38-52-152674,1850568,24,
1855694,1855717,2022-07-28_18-38-57-427549,1855721,23,
1860845,1860868,2022-07-28_18-39-02-702650,1860872,23,
1865949,1865973,2022-07-28_18-39-07-932848,1865977,24,
1871080,1871108,2022-07-28_18-39-13-188429,1871111,28,
1876188,1881295,2022-07-28_18-39-18-606215,1881306,5107,
1881319,1881344,2022-07-28_18-39-23-674639,1881348,25,
1886410,1886435,2022-07-28_18-39-28-889754,1886438,25,
1891549,1891573,2022-07-28_18-39-34-153600,1891576,24,
1896686,1896711,2022-07-28_18-39-39-413594,1896715,25,
1901838,1901862,2022-07-28_18-39-44-688681,1901865,24,
1906991,1907024,2022-07-28_18-39-49-973505,1907027,33,
1912137,1912161,2022-07-28_18-39-55-238193,1912164,24,
1917257,1917281,2022-07-28_18-40-00-477960,1917285,24,
1922393,1922417,2022-07-28_18-40-05-741192,1922421,24,
1927556,1927580,2022-07-28_18-40-11-031846,1927584,24,
1932666,1932692,2022-07-28_18-40-16-265841,1932695,26,
1937829,1937853,2022-07-28_18-40-21-550358,1937856,24,
1942962,1942987,2022-07-28_18-40-26-808371,1942990,25,
1948104,1948128,2022-07-28_18-40-32-077504,1948132,24,
1953211,1953233,2022-07-28_18-40-37-306172,1953236,22,
1958329,1958354,2022-07-28_18-40-42-546156,1958357,25,
1963436,1963460,2022-07-28_18-40-47-779711,1963464,24,
1968545,1968569,2022-07-28_18-40-53-010783,1968573,24,
1973692,1973718,2022-07-28_18-40-58-281729,1973722,26,
1978799,1978821,2022-07-28_18-41-03-511749,1978825,22,
1983954,1983980,2022-07-28_18-41-08-795605,1983983,26,
1989096,1989120,2022-07-28_18-41-14-058658,1989123,24,
1994242,1994267,2022-07-28_18-41-19-328872,1994271,25,
1999385,2004512,2022-07-28_18-41-24-595495,2004523,5127,
2004536,2004560,2022-07-28_18-41-29-873464,2004563,24,
2009624,2009648,2022-07-28_18-41-35-083850,2009651,24,
2014777,2014801,2022-07-28_18-41-40-361728,2014804,24,
2019928,2019956,2022-07-28_18-41-45-636147,2019959,28,
2025074,2025098,2022-07-28_18-41-50-906369,2025101,24,
2030181,2030205,2022-07-28_18-41-56-134837,2030208,24,
2035310,2035340,2022-07-28_18-42-01-388540,2035345,30,
2040418,2040442,2022-07-28_18-42-06-618449,2040446,24,
2045566,2045591,2022-07-28_18-42-11-891413,2045595,25,
2050704,2050728,2022-07-28_18-42-17-157677,2050732,24,
2055812,2055837,2022-07-28_18-42-22-390122,2055842,25,
2060966,2060995,2022-07-28_18-42-27-670863,2060998,29,
2066074,2066098,2022-07-28_18-42-32-900008,2066101,24,
2071182,2071207,2022-07-28_18-42-38-135244,2071210,25,
2076299,2076376,2022-07-28_18-42-43-418390,2076382,77,
2081404,2081471,2022-07-28_18-42-48-644129,2081477,67,
2086553,2086577,2022-07-28_18-42-53-875412,2086580,24,
2091657,2091695,2022-07-28_18-42-59-103103,2091700,38,
2096775,2096800,2022-07-28_18-43-04-340932,2096803,25,
2101873,2101902,2022-07-28_18-43-09-565637,2101905,29,
2106982,2107006,2022-07-28_18-43-14-795287,2107010,24,
2112101,2112155,2022-07-28_18-43-20-070642,2112166,54,
2117200,
2122295,2122319,2022-07-28_18-43-30-481641,2122322,24,
2127454,2127478,2022-07-28_18-43-35-766111,2127481,24,
2132563,2132654,2022-07-28_18-43-41-063467,2132658,91,
2137670,2137696,2022-07-28_18-43-46-228704,2137701,26,
2142777,2142806,2022-07-28_18-43-51-464004,2142809,29,
2147887,2152990,2022-07-28_18-43-56-740456,2153000,5103,
2153021,2153059,2022-07-28_18-44-01-963553,2153062,38,
2158111,2158168,2022-07-28_18-44-07-189192,2158172,57,
2163220,2163264,2022-07-28_18-44-12-412246,2163271,44,
2168326,2168357,2022-07-28_18-44-17-630698,2168360,31,
2173434,2173458,2022-07-28_18-44-22-857095,2173461,24,
2178538,2178566,2022-07-28_18-44-28-086046,2178569,28,
2183644,2188746,2022-07-28_18-44-33-504186,2188749,5102,
2188750,2188779,2022-07-28_18-44-38-542634,2188782,29,
2193858,2193885,2022-07-28_18-44-43-777045,2193889,27,
2198966,2199056,2022-07-28_18-44-49-067376,2199061,90,
2204120,2209282,2022-07-28_18-44-54-281353,2209292,5162,
2209308,2209332,2022-07-28_18-44-59-596112,2209335,24,
2214394,2214420,2022-07-28_18-45-04-807421,2214424,26,
2219502,2219525,2022-07-28_18-45-10-036317,2219529,23,
2224609,2224633,2022-07-28_18-45-15-267743,2224638,24,
2229720,2229744,2022-07-28_18-45-20-504407,2229748,24,
2234827,2234851,2022-07-28_18-45-25-735075,2234854,24,
2239983,2240008,2022-07-28_18-45-31-014198,2240012,25,
2245090,2245114,2022-07-28_18-45-36-243552,2245118,24,
2250197,2250223,2022-07-28_18-45-41-477088,2250226,26,
2255344,2255378,2022-07-28_18-45-46-746270,2255382,34,
2260480,2260504,2022-07-28_18-45-52-006628,2260508,24,
2265588,2265611,2022-07-28_18-45-57-240232,2265614,23,
2270723,2270747,2022-07-28_18-46-02-502252,2270751,24,
2275830,2275855,2022-07-28_18-46-07-730576,2275858,25,
2280943,2280968,2022-07-28_18-46-12-969254,2280971,25,
2286070,2286094,2022-07-28_18-46-18-219476,2286097,24,
2291213,2291238,2022-07-28_18-46-23-490208,2291241,25,
2296360,2296386,2022-07-28_18-46-28-759600,2296389,26,
2301521,2301548,2022-07-28_18-46-34-045773,2301551,27,
2306666,2306699,2022-07-28_18-46-39-321853,2306702,33,
2311774,2311798,2022-07-28_18-46-44-547844,2311801,24,
2316930,2316954,2022-07-28_18-46-49-826247,2316957,24,
2322041,2322067,2022-07-28_18-46-55-061541,2322070,26,
2327149,2327174,2022-07-28_18-47-00-293789,2327177,25,
2332282,2332305,2022-07-28_18-47-05-551143,2332308,23,
2337420,2337444,2022-07-28_18-47-10-808283,2337448,24,
2342567,2342616,2022-07-28_18-47-16-108319,2342619,49,
2347675,2347700,2022-07-28_18-47-21-315867,2347703,25,
2352818,2352842,2022-07-28_18-47-26-583359,2352845,24,
2357963,2358000,2022-07-28_18-47-31-864307,2358003,37,
2363102,2363126,2022-07-28_18-47-37-115580,2363131,24,
2368256,2368280,2022-07-28_18-47-42-394300,2368284,24,
2373402,2373425,2022-07-28_18-47-47-663579,2373428,23,
2378513,2383617,2022-07-28_18-47-53-282762,2383622,5104,
2383622,2388772,2022-07-28_18-47-58-288325,2388775,5150,
2388776,2388802,2022-07-28_18-48-03-410210,2388805,26,
2393905,2393929,2022-07-28_18-48-08-662776,2393933,24,
2399063,2399088,2022-07-28_18-48-13-944948,2399091,25,
2404208,2404232,2022-07-28_18-48-19-214600,2404235,24,
2409334,2409371,2022-07-28_18-48-24-466838,2409374,37,
2414452,2414475,2022-07-28_18-48-29-706757,2414479,23,
2419601,2419624,2022-07-28_18-48-34-981454,2419627,23,
2424747,2424772,2022-07-28_18-48-40-252804,2424776,25,
2429880,2429906,2022-07-28_18-48-45-511511,2429909,26,
2434981,2435010,2022-07-28_18-48-50-738007,2435012,29,
2440119,2440143,2022-07-28_18-48-55-996767,2440147,24,
2445243,2445267,2022-07-28_18-49-01-247199,2445271,24,
2450410,2450444,2022-07-28_18-49-06-549176,2450448,34,
2455528,2455553,2022-07-28_18-49-11-777802,2455556,25,
2460635,2460660,2022-07-28_18-49-17-007818,2460663,25,
2465807,2465832,2022-07-28_18-49-22-307765,2465837,25,
2470916,2470940,2022-07-28_18-49-27-537029,2470943,24,
2476023,2476047,2022-07-28_18-49-32-766741,2476050,24,
2481136,2481160,2022-07-28_18-49-38-004639,2481163,24,
2486244,2486268,2022-07-28_18-49-43-238639,2486272,24,
2491351,2491375,2022-07-28_18-49-48-467862,2491378,24,
2496460,2496495,2022-07-28_18-49-53-700976,2496498,35,
2501567,2501595,2022-07-28_18-49-58-932539,2501599,28,
2506676,2506699,2022-07-28_18-50-04-163906,2506702,23,
2511784,2511807,2022-07-28_18-50-09-395108,2511811,23,
2516892,2516919,2022-07-28_18-50-14-627710,2516923,27,
2522000,2522023,2022-07-28_18-50-19-859957,2522026,23,
2527107,2527131,2022-07-28_18-50-25-089804,2527135,24,
2532216,2532247,2022-07-28_18-50-30-324342,2532251,31,
2537325,2537351,2022-07-28_18-50-35-558260,2537354,26,
2542433,2542458,2022-07-28_18-50-40-786408,2542461,25,
2547541,2547566,2022-07-28_18-50-46-017493,2547569,25,
2552665,2552690,2022-07-28_18-50-51-265726,2552693,25,
2557771,2557795,2022-07-28_18-50-56-495243,2557798,24,
2562916,2562941,2022-07-28_18-51-01-761239,2562945,25,
2568027,2568051,2022-07-28_18-51-06-996458,2568055,24,
2573135,2573160,2022-07-28_18-51-12-226294,2573163,25,
2578243,2578283,2022-07-28_18-51-17-474008,2578287,40,
2583431,2583456,2022-07-28_18-51-22-771670,2583459,25,
2588542,2588567,2022-07-28_18-51-28-005467,2588570,25,
2593652,2593674,2022-07-28_18-51-33-237941,2593677,22,
2598794,2598819,2022-07-28_18-51-38-509015,2598822,25,
2603900,2603924,2022-07-28_18-51-43-737345,2603927,24,
2609074,2609097,2022-07-28_18-51-49-035973,2609101,23,
2614220,2614243,2022-07-28_18-51-54-307288,2614246,23,
2619354,2619378,2022-07-28_18-51-59-565213,2619381,24,
2624465,2624490,2022-07-28_18-52-04-798004,2624493,25,
2629572,2629596,2022-07-28_18-52-10-026219,2629601,24,
2634724,2634748,2022-07-28_18-52-15-309859,2634752,24,
2639893,2639917,2022-07-28_18-52-20-602347,2639921,24,
2645050,2645076,2022-07-28_18-52-25-880899,2645079,26,
2650157,2650181,2022-07-28_18-52-31-110990,2650184,24,
2655306,2655333,2022-07-28_18-52-36-385823,2655337,27,
2660450,2660473,2022-07-28_18-52-41-653580,2660477,23,
2665603,2665627,2022-07-28_18-52-46-930986,2665630,24,
2670759,2670784,2022-07-28_18-52-52-211110,2670787,25,
2675905,2675931,2022-07-28_18-52-57-483009,2675934,26,
2681045,2681081,2022-07-28_18-53-02-745223,2681084,36,
2686282,2686306,2022-07-28_18-53-08-108102,2686309,24,
2691396,2691421,2022-07-28_18-53-13-346060,2691424,25,
2696543,2696566,2022-07-28_18-53-18-618092,2696569,23,
2701680,2701705,2022-07-28_18-53-23-876923,2701708,25,
2706828,2706853,2022-07-28_18-53-29-148741,2706856,25,
2711985,2712012,2022-07-28_18-53-34-427895,2712015,27,
2717094,2717118,2022-07-28_18-53-39-663397,2717122,24,
2722202,2722227,2022-07-28_18-53-44-895340,2722230,25,
2727361,2727385,2022-07-28_18-53-50-179526,2727389,24,
2732469,2732493,2022-07-28_18-53-55-408473,2732496,24,
2737578,2737612,2022-07-28_18-54-00-649204,2737615,34,
2742705,2742735,2022-07-28_18-54-05-895669,2742738,30,
2747812,2747834,2022-07-28_18-54-11-118877,2747838,22,
2752920,2752945,2022-07-28_18-54-16-349595,2752949,25,
2758043,2758066,2022-07-28_18-54-21-597745,2758069,23,
2763186,2763211,2022-07-28_18-54-26-864701,2763215,25,
2768315,2768338,2022-07-28_18-54-32-117745,2768342,23,
2773459,2773500,2022-07-28_18-54-37-388159,2773504,41,
2778567,2778593,2022-07-28_18-54-42-619092,2778596,26,
2783676,2783700,2022-07-28_18-54-47-846647,2783704,24,
2788802,2788827,2022-07-28_18-54-53-097344,2788831,25,
2793911,2793934,2022-07-28_18-54-58-331438,2793938,23,
2799055,2799078,2022-07-28_18-55-03-598109,2799083,23,
2804185,2804214,2022-07-28_18-55-08-851608,2804218,29,
2809321,2809345,2022-07-28_18-55-14-111089,2809349,24,
2814448,
2819574,2819598,2022-07-28_18-55-24-611747,2819602,24,
2824704,2824745,2022-07-28_18-55-29-882586,2824748,41,
2829859,2829885,2022-07-28_18-55-35-147684,2829890,26,
2834995,2835019,2022-07-28_18-55-40-410021,2835022,24,
2840145,2840169,2022-07-28_18-55-45-684473,2840173,24,
2845289,2845317,2022-07-28_18-55-50-950835,2845320,28,
2850438,2850462,2022-07-28_18-55-56-227308,2850465,24,
2855565,2855589,2022-07-28_18-56-01-476265,2855592,24,
2860699,2860724,2022-07-28_18-56-06-733570,2860728,25,
2865798,2865828,2022-07-28_18-56-11-954781,2865831,30,
2870964,2870996,2022-07-28_18-56-17-255614,2870999,32,
2876069,2876093,2022-07-28_18-56-22-474217,2876096,24,
2881176,2881198,2022-07-28_18-56-27-700777,2881202,22,
2886313,2886340,2022-07-28_18-56-32-968229,2886343,27,
2891423,2891449,2022-07-28_18-56-38-201672,2891453,26,
2896566,2896590,2022-07-28_18-56-43-466997,2896593,24,
2901673,2901697,2022-07-28_18-56-48-695619,2901702,24,
2906787,2906849,2022-07-28_18-56-53-967588,2906852,62,
2911916,2911941,2022-07-28_18-56-59-188447,2911944,25,
2917019,2917044,2022-07-28_18-57-04-411284,2917047,25,
2922124,2922149,2022-07-28_18-57-09-639087,2922152,25,
2927233,2932327,2022-07-28_18-57-15-058270,2932337,5094,
2932337,2932437,2022-07-28_18-57-20-174397,2932440,100,
2937504,2937538,2022-07-28_18-57-25-396811,2937542,34,
2942612,2942640,2022-07-28_18-57-30-620353,2942643,28,
2947717,2947739,2022-07-28_18-57-35-850135,2947743,22,
2952825,2952849,2022-07-28_18-57-41-081352,2952852,24,
2957931,2963043,2022-07-28_18-57-46-505370,2963048,5112,
2963049,2963128,2022-07-28_18-57-51-609374,2963131,79,
2968191,2973364,2022-07-28_18-57-57-043197,2973370,5173,
2973370,2973435,2022-07-28_18-58-02-165553,2973439,65,
2978514,2978545,2022-07-28_18-58-07-392191,2978551,31,
2983619,2983645,2022-07-28_18-58-12-623036,2983648,26,
2988720,2993903,2022-07-28_18-58-18-035463,2993908,5183,
2993908,2993937,2022-07-28_18-58-23-159417,2993944,29,
2999010,3004112,2022-07-28_18-58-28-400746,3004122,5102,
3004145,3004221,2022-07-28_18-58-33-697637,3004226,76,
3009260,3009331,2022-07-28_18-58-38-929108,3009337,71,
3014398,3019498,2022-07-28_18-58-44-355684,3019503,5100,
3019503,3019527,2022-07-28_18-58-49-377456,3019530,24,
3024613,3024731,2022-07-28_18-58-54-698250,3029708,118,
3029722,3029746,2022-07-28_18-58-59-842675,3029749,24,
3034821,3034850,2022-07-28_18-59-05-063752,3034853,29,
3039936,3040013,2022-07-28_18-59-10-356818,3040016,77,
3045069,3045125,2022-07-28_18-59-15-587512,3045130,56,
3050178,3050222,2022-07-28_18-59-20-809045,3050228,44,
3055344,3055429,2022-07-28_18-59-26-136479,3055434,85,
3060446,3065580,2022-07-28_18-59-31-475782,3065586,5134,
3065586,3065618,2022-07-28_18-59-36-580324,3065621,32,
3070691,3070717,2022-07-28_18-59-41-801309,3070720,26,
3075795,3075820,2022-07-28_18-59-47-030004,3075823,25,
3080901,3086005,2022-07-28_18-59-52-449115,3086008,5104,
3086009,3086032,2022-07-28_18-59-57-489337,3086036,23,
3091165,3091189,2022-07-28_19-00-02-767773,3091193,24,
3096319,3101420,2022-07-28_19-00-08-048603,3101434,5101,
3101457,3101519,2022-07-28_19-00-13-338656,3101525,62,
3106578,3106616,2022-07-28_19-00-18-563952,3106621,38,
3111696,3116792,2022-07-28_19-00-23-925074,3116802,5096,
3116815,3116845,2022-07-28_19-00-29-040802,3116848,30,
3121910,3121933,2022-07-28_19-00-34-253817,3121937,23,
3127012,3127039,2022-07-28_19-00-39-480498,3127042,27,
3132120,3132145,2022-07-28_19-00-44-713280,3132148,25,
3137234,3137323,2022-07-28_19-00-50-000430,3137326,89,
3142338,3142360,2022-07-28_19-00-55-175887,3142364,22,
3147556,3147607,2022-07-28_19-01-00-547649,3147611,51,
3152660,3152686,2022-07-28_19-01-05-750734,3152690,26,
3157778,3157802,2022-07-28_19-01-10-992744,3157805,24,
3162886,3162927,2022-07-28_19-01-16-240181,3162930,41,
3167993,3168019,2022-07-28_19-01-21-454292,3168022,26,
3173144,3173168,2022-07-28_19-01-26-729933,3173172,24,
3178305,3178330,2022-07-28_19-01-32-014121,3178333,25,
3183412,3183503,2022-07-28_19-01-37-309013,3183511,91,
3188520,3188544,2022-07-28_19-01-42-478469,3188547,24,
3193659,3193693,2022-07-28_19-01-47-755956,3193696,34,
3198766,3198795,2022-07-28_19-01-52-977418,3198799,29,
3203910,3203934,2022-07-28_19-01-58-243159,3203938,24,
3209085,3214220,2022-07-28_19-02-03-726446,3214226,5135,
3214226,3214305,2022-07-28_19-02-08-850673,3214310,79,
3219327,3219363,2022-07-28_19-02-14-034517,3219366,36,
3224444,3224489,2022-07-28_19-02-19-291269,3224493,45,
3229551,3229581,2022-07-28_19-02-24-508486,3229584,30,
3234695,3234720,2022-07-28_19-02-29-771186,3234724,25,
3239819,3239843,2022-07-28_19-02-35-017002,3239846,24,
3244978,3245003,2022-07-28_19-02-40-300627,3245007,25,
3250144,3250192,2022-07-28_19-02-45-611783,3250195,48,
3255251,3255284,2022-07-28_19-02-50-830733,3255287,33,
3260360,3260391,2022-07-28_19-02-56-057723,3260394,31,
3265464,3265582,2022-07-28_19-03-01-381123,3270562,118,
3270576,3270603,2022-07-28_19-03-06-516139,3270606,27,
3275696,3275768,2022-07-28_19-03-11-811195,3275772,72,
3280819,3280882,2022-07-28_19-03-17-049188,3280886,63,
3285917,3285942,2022-07-28_19-03-22-227374,3285945,25,
3291035,3291084,2022-07-28_19-03-27-493954,3291090,49,
3296153,3296177,2022-07-28_19-03-32-710260,3296180,24,
3301258,3301380,2022-07-28_19-03-38-040321,3306362,122,
3306376,3306400,2022-07-28_19-03-43-182101,3306404,24,
3311471,3311574,2022-07-28_19-03-48-482556,3311577,103,
3316591,3316676,2022-07-28_19-03-53-707799,3316680,85,
3321761,3321804,2022-07-28_19-03-58-948653,3321809,43,
3326887,3326916,2022-07-28_19-04-04-193208,3326919,29,
3332004,3337149,2022-07-28_19-04-09-679638,3337153,5145,
3337153,3337178,2022-07-28_19-04-14-707532,3337181,25,
3342291,3342376,2022-07-28_19-04-20-027222,3342381,85,
3347400,3347475,2022-07-28_19-04-25-250367,3347481,75,
3352560,3352595,2022-07-28_19-04-30-496612,3352599,35,
3357661,3357683,2022-07-28_19-04-35-709138,3357686,22,
3362769,3362793,2022-07-28_19-04-40-940397,3362796,24,
3367877,3367901,2022-07-28_19-04-46-172704,3367904,24,
3373034,3373062,2022-07-28_19-04-51-459039,3373066,28,
3378180,3378208,2022-07-28_19-04-56-721960,3378213,28,
3383287,3383317,2022-07-28_19-05-01-958069,3383320,30,
3388394,3388418,2022-07-28_19-05-07-185542,3388421,24,
3393502,3393529,2022-07-28_19-05-12-419742,3393539,27,
3398611,3398636,2022-07-28_19-05-17-652192,3398640,25,
3403719,3408868,2022-07-28_19-05-23-043054,3408872,5149,
3408872,3408895,2022-07-28_19-05-28-161307,3408899,23,
3414018,3414041,2022-07-28_19-05-33-427808,3414045,23,
3419126,3419155,2022-07-28_19-05-38-661591,3419158,29,
3424237,3424262,2022-07-28_19-05-43-896893,3424266,25,
3429345,3429369,2022-07-28_19-05-49-125724,3429372,24,
3434506,3434530,2022-07-28_19-05-54-410449,3434534,24,
3439614,3439640,2022-07-28_19-05-59-643217,3439643,26,
3444738,3444764,2022-07-28_19-06-04-895106,3444767,26,
3449845,3449870,2022-07-28_19-06-10-123424,3449874,25,
3455003,3455028,2022-07-28_19-06-15-402841,3455032,25,
3460149,
3465286,3465351,2022-07-28_19-06-25-978717,3465357,65,
3470406,3470432,2022-07-28_19-06-31-182267,3470436,26,
3475532,3475560,2022-07-28_19-06-36-429510,3475563,28,
3480637,3485810,2022-07-28_19-06-41-850695,3485813,5173,
3485814,3485842,2022-07-28_19-06-46-964322,3485845,28,
3490925,3490951,2022-07-28_19-06-52-196920,3490954,26,
3496037,3496163,2022-07-28_19-06-57-520016,3501124,126,
3501153,3501237,2022-07-28_19-07-02-733102,3501239,84,
3506248,3506331,2022-07-28_19-07-07-951547,3506335,83,
3511384,3511408,2022-07-28_19-07-13-150419,3511412,24,
3516499,3516540,2022-07-28_19-07-18-405267,3516545,41,
3521611,3521639,2022-07-28_19-07-23-627482,3521643,28,
3526759,3526847,2022-07-28_19-07-28-958845,3526854,88,
3531916,3531942,2022-07-28_19-07-34-180162,3531946,26,
3537061,3537159,2022-07-28_19-07-39-523524,3537162,98,
3542204,3542235,2022-07-28_19-07-44-726336,3542238,31,
3547309,3547333,2022-07-28_19-07-49-945621,3547337,24,
3552449,3552536,2022-07-28_19-07-55-269958,3552542,87,
3557557,3557581,2022-07-28_19-08-00-442306,3557585,24,
3562663,3562732,2022-07-28_19-08-05-714227,3562735,69,
3567779,3567831,2022-07-28_19-08-10-931963,3567837,52,
3572888,3572942,2022-07-28_19-08-16-165761,3572948,54,
3577996,3578042,2022-07-28_19-08-21-391808,3578048,46,
3583148,3583218,2022-07-28_19-08-26-701499,3583223,70,
3588282,3588328,2022-07-28_19-08-31-930138,3588331,46,
3593389,3593439,2022-07-28_19-08-37-160489,3593445,50,
3598492,3598517,2022-07-28_19-08-42-375018,3598520,25,
3603601,3603628,2022-07-28_19-08-47-602743,3603631,27,
3608712,3608828,2022-07-28_19-08-52-924114,3613813,116,
3613829,3613854,2022-07-28_19-08-58-078191,3613856,25,
3618970,3619016,2022-07-28_19-09-03-361368,3619022,46,
3624075,3624129,2022-07-28_19-09-08-601199,3624133,54,
3629184,3629216,2022-07-28_19-09-13-811353,3629220,32,
3634289,3634315,2022-07-28_19-09-19-035393,3634318,26,
3639394,3639418,2022-07-28_19-09-24-259350,3639421,24,
3644503,3644528,2022-07-28_19-09-29-492641,3644532,25,
3649680,3649704,2022-07-28_19-09-34-798052,3649708,24,
3654823,3654868,2022-07-28_19-09-40-072452,3654871,45,
3659933,3660001,2022-07-28_19-09-45-345197,3660005,68,
3665050,3665073,2022-07-28_19-09-50-537153,3665076,23,
3670169,3670205,2022-07-28_19-09-55-794870,3670208,36,
3675277,3675303,2022-07-28_19-10-01-013502,3675306,26,
3680386,3685509,2022-07-28_19-10-06-444999,3685512,5123,
3685512,3685538,2022-07-28_19-10-11-497071,3685542,26,
3690622,3690717,2022-07-28_19-10-16-787259,3690722,95,
3695762,3695794,2022-07-28_19-10-21-999121,3695798,32,
3700877,3705978,2022-07-28_19-10-27-338841,3705993,5101,
3706016,3706107,2022-07-28_19-10-32-560307,3706112,91,
3711087,3711111,2022-07-28_19-10-37-694013,3711115,24,
3716195,3716220,2022-07-28_19-10-42-922394,3716223,25,
3721345,3721368,2022-07-28_19-10-48-197115,3721372,23,
3726454,3726478,2022-07-28_19-10-53-430430,3726481,24,
3731571,3731594,2022-07-28_19-10-58-670804,3731597,23,
3736672,3736696,2022-07-28_19-11-03-894670,3736699,24,
3741839,3741888,2022-07-28_19-11-09-210275,3741893,49,
3746941,3746993,2022-07-28_19-11-14-439000,3746998,52,
3752174,3752204,2022-07-28_19-11-19-770307,3752210,30,
3757277,3757302,2022-07-28_19-11-24-994429,3757305,25,
3762432,3762455,2022-07-28_19-11-30-275104,3762458,23,
3767546,3767596,2022-07-28_19-11-35-534610,3767599,50,
3772657,3772697,2022-07-28_19-11-40-759857,3772703,40,
3777764,3777790,2022-07-28_19-11-45-980043,3777793,26,
3782868,3782891,2022-07-28_19-11-51-208906,3782894,23,
3787994,3788020,2022-07-28_19-11-56-459884,3788023,26,
3793153,3793187,2022-07-28_19-12-01-738270,3793191,34,
3798249,3798296,2022-07-28_19-12-06-974025,3798300,47,
3803368,3803394,2022-07-28_19-12-12-204797,3803397,26,
3808482,3808508,2022-07-28_19-12-17-441011,3808511,26,
3813657,3813682,2022-07-28_19-12-22-740023,3813686,25,
3818808,3818833,2022-07-28_19-12-28-015914,3818836,25,
3823943,3823971,2022-07-28_19-12-33-278456,3823975,28,
3829051,3829077,2022-07-28_19-12-38-509735,3829080,26,
3834159,3834185,2022-07-28_19-12-43-739553,3834187,26,
3839272,3839296,2022-07-28_19-12-48-974444,3839299,24,
3844381,3844404,2022-07-28_19-12-54-209895,3844408,23,
3849488,3849512,2022-07-28_19-12-59-437774,3849516,24,
3854637,3854665,2022-07-28_19-13-04-714444,3854668,28,
3859743,3859767,2022-07-28_19-13-09-940186,3859770,24,
3864878,3864901,2022-07-28_19-13-15-199973,3864904,23,
3870020,3870043,2022-07-28_19-13-20-464039,3870047,23,
3875159,3875189,2022-07-28_19-13-25-732336,3875192,30,
3880314,3880338,2022-07-28_19-13-31-010104,3880341,24,
3885468,3885493,2022-07-28_19-13-36-287929,3885496,25,
3890580,3890606,2022-07-28_19-13-41-524007,3890610,26,
3895715,3895744,2022-07-28_19-13-46-785151,3895748,29,
3900862,3900926,2022-07-28_19-13-52-084248,3900929,64,
3906005,3906058,2022-07-28_19-13-57-349097,3906061,53,
3911119,3911143,2022-07-28_19-14-02-557442,3911146,24,
3916293,3916318,2022-07-28_19-14-07-860098,3916321,25,
3921450,3921475,2022-07-28_19-14-13-139989,3921479,25,
3926555,3926607,2022-07-28_19-14-18-369118,3926610,52,
3931669,3931693,2022-07-28_19-14-23-604438,3931697,24,
3936969,3936993,2022-07-28_19-14-29-033600,3936996,24,
3942102,3942129,2022-07-28_19-14-34-295046,3942132,27,
3947250,3947276,2022-07-28_19-14-39-566651,3947279,26,
3952398,3952425,2022-07-28_19-14-44-841003,3952428,27,
3957505,3957529,2022-07-28_19-14-50-067664,3957533,24,
3962611,3962638,2022-07-28_19-14-55-299533,3962642,27,
3967766,3967790,2022-07-28_19-15-00-580542,3967794,24,
3972914,3972941,2022-07-28_19-15-05-853231,3972944,27,
3978057,3978085,2022-07-28_19-15-11-121746,3978088,28,
3983200,3983224,2022-07-28_19-15-16-387916,3983227,24,
3988346,3988376,2022-07-28_19-15-21-658622,3988379,30,
3993454,3993485,2022-07-28_19-15-26-886966,3993488,31,
3998589,3998621,2022-07-28_19-15-32-154714,3998625,32,
4003731,4003755,2022-07-28_19-15-37-417362,4003758,24,
4008871,4008894,2022-07-28_19-15-42-678578,4008898,23,
4014014,4014039,2022-07-28_19-15-47-947272,4014042,25,
4019147,4019172,2022-07-28_19-15-53-203658,4019176,25,
4024291,4024314,2022-07-28_19-15-58-473425,4024318,23,
4029447,4029471,2022-07-28_19-16-03-753319,4029474,24,
4034559,4034588,2022-07-28_19-16-08-990553,4034591,29,
4039864,4039887,2022-07-28_19-16-14-422651,4039892,23,
4045017,4045047,2022-07-28_19-16-19-700928,4045051,30,
4050147,4050170,2022-07-28_19-16-24-955210,4050175,23,
4055291,4055314,2022-07-28_19-16-30-220650,4055317,23,
4060399,4060422,2022-07-28_19-16-35-455490,4060426,23,
4065506,4065532,2022-07-28_19-16-40-690228,4065535,26,
4070615,4070643,2022-07-28_19-16-45-923863,4070646,28,
4075723,4075753,2022-07-28_19-16-51-153521,4075756,30,
4080831,4080855,2022-07-28_19-16-56-382947,4080858,24,
4085997,4086023,2022-07-28_19-17-01-676290,4086027,26,
4091105,4091129,2022-07-28_19-17-06-907751,4091132,24,
4096224,4096320,2022-07-28_19-17-12-222658,4096323,96,
4101393,4101417,2022-07-28_19-17-17-443064,4101421,24,
4106501,4106525,2022-07-28_19-17-22-676499,4106528,24,
4111604,4111629,2022-07-28_19-17-27-904893,4111632,25,
4116709,
4121823,4121926,2022-07-28_19-17-38-447887,4121931,103,
4126983,4127030,2022-07-28_19-17-43-670476,4127036,47,
4132090,4132118,2022-07-28_19-17-48-887107,4132121,28,
4137207,4137247,2022-07-28_19-17-54-135293,4137250,40,
4142315,4142338,2022-07-28_19-17-59-360602,4142342,23,
4147422,4147514,2022-07-28_19-18-04-658640,4147520,92,
4152546,4152571,2022-07-28_19-18-09-839660,4152574,25,
4157664,4157706,2022-07-28_19-18-15-093853,4157711,42,
4162771,4162814,2022-07-28_19-18-20-328156,4162820,43,
4167878,4172974,2022-07-28_19-18-25-556865,4172984,5096,
4172997,4173022,2022-07-28_19-18-30-783435,4173026,25,
4178086,4178112,2022-07-28_19-18-35-994970,4178117,26,
4183193,4183219,2022-07-28_19-18-41-226472,4183222,26,
4188308,4188332,2022-07-28_19-18-46-461454,4188336,24,
4193411,4193434,2022-07-28_19-18-51-688261,4193438,23,
4198560,4198597,2022-07-28_19-18-56-974400,4198600,37,
4203668,4203704,2022-07-28_19-19-02-202974,4203708,36,
4208774,4208806,2022-07-28_19-19-07-431821,4208809,32,
4213882,4213906,2022-07-28_19-19-12-655871,4213910,24,
4218991,4219016,2022-07-28_19-19-17-890060,4219020,25,
4224105,4224130,2022-07-28_19-19-23-122882,4224133,25,
4229207,4229239,2022-07-28_19-19-28-350037,4229242,32,
4234315,4234340,2022-07-28_19-19-33-581447,4234343,25,
4239469,4239495,2022-07-28_19-19-38-859938,4239499,26,
4244576,4244606,2022-07-28_19-19-44-088111,4244610,30,
4249685,4249713,2022-07-28_19-19-49-323393,4249717,28,
4254794,4254817,2022-07-28_19-19-54-552292,4254821,23,
4259901,4259925,2022-07-28_19-19-59-781724,4259928,24,
4265009,4265034,2022-07-28_19-20-05-014809,4265038,25,
4270158,4270191,2022-07-28_19-20-10-298662,4270195,33,
4275290,4275313,2022-07-28_19-20-15-543315,4275318,23,
4280436,4280465,2022-07-28_19-20-20-816960,4280468,29,
4285564,4285602,2022-07-28_19-20-26-073669,4285605,38,
4290720,4290744,2022-07-28_19-20-31-348586,4290747,24,
4295864,4295888,2022-07-28_19-20-36-619777,4295891,24,
4300970,4300994,2022-07-28_19-20-41-846328,4300997,24,
4306112,4306136,2022-07-28_19-20-47-112672,4306139,24,
4311261,4311288,2022-07-28_19-20-52-389487,4311291,27,
4316429,4316453,2022-07-28_19-20-57-679278,4316456,24,
4321537,4321561,2022-07-28_19-21-02-909710,4321565,24,
4326690,4326714,2022-07-28_19-21-08-187636,4326718,24,
4331819,4331848,2022-07-28_19-21-13-447740,4331852,29,
4336928,4336951,2022-07-28_19-21-18-676946,4336954,23,
4342069,4342093,2022-07-28_19-21-23-941299,4342097,24,
4347215,4347242,2022-07-28_19-21-29-215284,4347247,27,
4352342,4352366,2022-07-28_19-21-34-464781,4352369,24,
4357478,4357504,2022-07-28_19-21-39-726075,4357508,26,
4362626,4362651,2022-07-28_19-21-44-995794,4362655,25,
4367767,4367791,2022-07-28_19-21-50-262520,4367795,24,
4372874,4372903,2022-07-28_19-21-55-492586,4372906,29,
4377981,4378007,2022-07-28_19-22-00-721072,4378010,26,
4383124,4383149,2022-07-28_19-22-05-988647,4383152,25,
4388267,4388290,2022-07-28_19-22-11-258004,4388293,23,
4393406,4393435,2022-07-28_19-22-16-527686,4393438,29,
4398513,4398538,2022-07-28_19-22-21-750564,4398542,25,
4403621,4403650,2022-07-28_19-22-26-987804,4403654,29,
4408774,4408803,2022-07-28_19-22-32-260704,4408806,29,
4413891,4413919,2022-07-28_19-22-37-503376,4413922,28,
4419053,4419082,2022-07-28_19-22-42-793230,4419085,29,
4424172,4424266,2022-07-28_19-22-48-098920,4424271,94,
4429345,4429368,2022-07-28_19-22-53-330369,4429372,23,
4434453,4434477,2022-07-28_19-22-58-561244,4434481,24,
4439559,4439589,2022-07-28_19-23-03-792120,4439592,30,
4444670,4444698,2022-07-28_19-23-09-026395,4444701,28,
4449834,4449866,2022-07-28_19-23-14-317748,4449869,32,
4454968,4454992,2022-07-28_19-23-19-571008,4454995,24,
4460130,4460170,2022-07-28_19-23-24-869806,4460174,40,
4465227,4465254,2022-07-28_19-23-30-082535,4465257,27,
4470338,4470371,2022-07-28_19-23-35-316485,4470377,33,
4475469,4475578,2022-07-28_19-23-40-634519,4480578,109,
4480601,4480668,2022-07-28_19-23-45-859794,4480674,67,
4485671,4485778,2022-07-28_19-23-51-092735,4490794,107,
4490818,4490854,2022-07-28_19-23-56-302022,4490860,36,
4495934,4495957,2022-07-28_19-24-01-529647,4495961,23,
4501043,4506201,2022-07-28_19-24-06-956478,4506208,5158,
4506208,4506251,2022-07-28_19-24-12-071469,4506255,43,
4511342,4511367,2022-07-28_19-24-17-308417,4511370,25,
4516437,4516462,2022-07-28_19-24-22-527575,4516465,25,
4521546,4521571,2022-07-28_19-24-27-760012,4521575,25,
4526654,4526680,2022-07-28_19-24-32-989564,4526683,26,
4531809,4531835,2022-07-28_19-24-38-271856,4531838,26,
4536916,4536942,2022-07-28_19-24-43-499838,4536945,26,
4542044,4542073,2022-07-28_19-24-48-758327,4542076,29,
4547152,4547177,2022-07-28_19-24-53-985309,4547180,25,
4552259,4552283,2022-07-28_19-24-59-214135,4552286,24,
4557368,4557394,2022-07-28_19-25-04-449552,4557398,26,
4562476,4562504,2022-07-28_19-25-09-684472,4562507,28,
4567584,4567611,2022-07-28_19-25-14-913014,4567614,27,
4572691,4572715,2022-07-28_19-25-20-141629,4572718,24,
4577821,4577845,2022-07-28_19-25-25-397104,4577849,24,
4582927,4582952,2022-07-28_19-25-30-626002,4582956,25,
4588037,4588072,2022-07-28_19-25-35-867507,4588075,35,
4593145,4593173,2022-07-28_19-25-41-094546,4593176,28,
4598304,4598328,2022-07-28_19-25-46-373084,4598331,24,
4603411,4603437,2022-07-28_19-25-51-605159,4603440,26,
4608518,4608544,2022-07-28_19-25-56-836538,4608548,26,
4613678,4613701,2022-07-28_19-26-02-120795,4613704,23,
4618785,4618810,2022-07-28_19-26-07-355077,4618815,25,
4623945,4624015,2022-07-28_19-26-12-675335,4624019,70,
4629075,4629099,2022-07-28_19-26-17-892156,4629104,24,
4634190,4634214,2022-07-28_19-26-23-131347,4634218,24,
4639317,4639342,2022-07-28_19-26-28-381582,4639346,25,
4644468,4644493,2022-07-28_19-26-33-659277,4644497,25,
4649641,4649667,2022-07-28_19-26-38-955029,4649670,26,
4654759,4654783,2022-07-28_19-26-44-197679,4654786,24,
4659926,4659952,2022-07-28_19-26-49-492558,4659956,26,
4665035,4665058,2022-07-28_19-26-54-723081,4665061,23,
4670186,4670211,2022-07-28_19-26-59-998364,4670214,25,
4675367,4675393,2022-07-28_19-27-05-305109,4675396,26,
4680484,4680515,2022-07-28_19-27-10-547579,4680518,31,