RD,TS_received,TS_sent,AK,RoundTrip,
8329613,8329638,2022-08-16_14-15-34-113027,8329641,25,
8334768,8334794,2022-08-16_14-15-39-406227,8334798,26,
8339874,8339899,2022-08-16_14-15-44-648399,8339902,25,
8344983,8345008,2022-08-16_14-15-49-891031,8345013,25,
8350091,8350114,2022-08-16_14-15-55-130222,8350117,23,
8355199,8355222,2022-08-16_14-16-00-371666,8355226,23,
8360307,8360329,2022-08-16_14-16-05-611945,8360332,22,
8365417,8365442,2022-08-16_14-16-10-856957,8365446,25,
8370523,8370554,2022-08-16_14-16-16-095724,8370558,31,
8375631,8375669,2022-08-16_14-16-21-341588,8375673,38,
8380740,8380764,2022-08-16_14-16-26-579739,8380767,24,
8385894,8385939,2022-08-16_14-16-31-888266,8385942,45,
8391002,8391029,2022-08-16_14-16-37-117847,8391032,27,
8396164,8396189,2022-08-16_14-16-42-407194,8396192,25,
8401311,8401335,2022-08-16_14-16-47-686845,8401338,24,
8406440,8406472,2022-08-16_14-16-52-951859,8406476,32,
8411594,8411622,2022-08-16_14-16-58-243092,8411627,28,
8416725,8416751,2022-08-16_14-17-03-505210,8416754,26,
8421899,8421923,2022-08-16_14-17-08-814021,8421926,24,
8427040,8427066,2022-08-16_14-17-14-087984,8427069,26,
8432151,8432176,2022-08-16_14-17-19-332967,8432180,25,
8437300,8437325,2022-08-16_14-17-24-613853,8437328,25,
8442417,8442442,2022-08-16_14-17-29-864886,8442445,25,
8447565,8447592,2022-08-16_14-17-35-144277,8447596,27,
8452704,8452728,2022-08-16_14-17-40-419675,8452732,24,
8457852,8457877,2022-08-16_14-17-45-701449,8457880,25,
8462985,8463009,2022-08-16_14-17-50-962095,8463012,24,
8468140,8468166,2022-08-16_14-17-56-252801,8468169,26,
8473277,8473304,2022-08-16_14-18-01-525325,8473307,27,
8478397,8478421,2022-08-16_14-18-06-775680,8478425,24,
8483497,8483521,2022-08-16_14-18-12-007077,8483526,24,
8488605,8493749,2022-08-16_14-18-17-365456,8493764,5144,
8493780,
8498840,8504004,2022-08-16_14-18-27-844808,8504020,5164,
8504044,8504085,2022-08-16_14-18-33-102200,8504088,41,
8509139,8509174,2022-08-16_14-18-38-325570,8509177,35,
8514238,8514307,2022-08-16_14-18-43-588267,8514312,69,
8519345,8519405,2022-08-16_14-18-48-821165,8519408,60,
8524486,8524517,2022-08-16_14-18-54-063916,8524520,31,
8529607,8529671,2022-08-16_14-18-59-359341,8529675,64,
8534752,8539896,2022-08-16_14-19-04-673105,8539906,5144,
8539919,8540036,2022-08-16_14-19-09-981435,8545107,117,
8545120,8545187,2022-08-16_14-19-15-249146,8545191,67,
8550217,8550244,2022-08-16_14-19-20-467324,8550248,27,
8555354,8555386,2022-08-16_14-19-25-739514,8555389,32,
8560498,8560522,2022-08-16_14-19-31-008295,8560526,24,
8565606,8565632,2022-08-16_14-19-36-252254,8565635,26,
8570765,8570794,2022-08-16_14-19-41-544795,8570797,29,
8575899,8575925,2022-08-16_14-19-46-814233,8575934,26,
8581007,8581033,2022-08-16_14-19-52-054419,8581037,26,
8586131,8591260,2022-08-16_14-19-57-698192,8591270,5129,
8591285,8591313,2022-08-16_14-20-02-597775,8591316,28,
8596359,8596392,2022-08-16_14-20-07-808874,8596395,33,
8601480,8606611,2022-08-16_14-20-13-518530,8606622,5131,
8606635,8606659,2022-08-16_14-20-18-334177,8606662,24,
8611722,8611747,2022-08-16_14-20-23-556320,8611750,25,
8616852,8616880,2022-08-16_14-20-28-821387,8616883,28,
8621959,8621983,2022-08-16_14-20-34-060869,8621987,24,
8627068,8627093,2022-08-16_14-20-39-298238,8627097,25,
8632195,8632222,2022-08-16_14-20-44-561083,8632225,27,
8637294,8637320,2022-08-16_14-20-49-787793,8637323,26,
8642401,8642426,2022-08-16_14-20-55-025333,8642430,25,
8647518,8647547,2022-08-16_14-21-00-277683,8647550,29,
8652647,8652669,2022-08-16_14-21-05-534613,8652673,22,
8657755,8657777,2022-08-16_14-21-10-773164,8657781,22,
8662865,8662889,2022-08-16_14-21-16-011040,8662892,24,
8667972,8667999,2022-08-16_14-21-21-251471,8668002,27,
8673116,8673167,2022-08-16_14-21-26-548172,8673170,51,
8678229,8678256,2022-08-16_14-21-31-770565,8678259,27,
8683333,8683358,2022-08-16_14-21-37-005619,8683361,25,
8688441,8688470,2022-08-16_14-21-42-242980,8688473,29,
8693547,8693571,2022-08-16_14-21-47-479205,8693575,24,
8698661,8698740,2022-08-16_14-21-52-770774,8698743,79,
8703786,8703829,2022-08-16_14-21-57-997312,8703836,43,
8708891,8708926,2022-08-16_14-22-03-223723,8708931,35,
8713979,8714010,2022-08-16_14-22-08-444658,8714016,31,
8719141,8719166,2022-08-16_14-22-13-736146,8719169,25,
8724259,8724306,2022-08-16_14-22-18-995754,8724311,47,
8729363,8734510,2022-08-16_14-22-24-413766,8734515,5147,
8734516,8734576,2022-08-16_14-22-29-535646,8734582,60,
8739636,8739672,2022-08-16_14-22-34-766495,8739676,36,
8744736,8744760,2022-08-16_14-22-39-992530,8744763,24,
8749906,8749931,2022-08-16_14-22-45-294318,8749934,25,
8755075,8755100,2022-08-16_14-22-50-593859,8755104,25,
8760193,8760225,2022-08-16_14-22-55-849950,8760228,32,
8765297,8765410,2022-08-16_14-23-01-174839,8770412,113,
8770427,8770450,2022-08-16_14-23-06-346911,8770453,23,
8775532,8775593,2022-08-16_14-23-11-619812,8775598,61,
8780641,8780689,2022-08-16_14-23-16-842247,8780694,48,
8785753,8785784,2022-08-16_14-23-22-065970,8785789,31,
8790852,8790878,2022-08-16_14-23-27-297425,8790881,26,
8795969,8795994,2022-08-16_14-23-32-541811,8795998,25,
8801231,8801260,2022-08-16_14-23-37-938631,8801263,29,
8806342,8806442,2022-08-16_14-23-43-256736,8806445,100,
8811460,8811525,2022-08-16_14-23-48-477383,8811529,65,
8816619,8816645,2022-08-16_14-23-53-726175,8816648,26,
8821727,8826837,2022-08-16_14-23-59-133368,8826843,5110,
8826843,8826902,2022-08-16_14-24-04-246412,8826907,59,
8831946,8831972,2022-08-16_14-24-09-445120,8831975,26,
8837103,8837128,2022-08-16_14-24-14-730849,8837131,25,
8842221,8842290,2022-08-16_14-24-20-023691,8842296,69,
8847367,8847392,2022-08-16_14-24-25-261099,8847396,25,
8852466,8852491,2022-08-16_14-24-30-492876,8852495,25,
8857615,8857660,2022-08-16_14-24-35-794411,8857663,45,
8862768,8862852,2022-08-16_14-24-41-118228,8862856,84,
8867916,8867968,2022-08-16_14-24-46-357792,8867971,52,
8873017,8873051,2022-08-16_14-24-51-580206,8873054,34,
8878122,8878150,2022-08-16_14-24-56-807862,8878153,28,
8883241,8883315,2022-08-16_14-25-02-104090,8883318,74,
8888349,8888402,2022-08-16_14-25-07-327014,8888405,53,
8893458,8893511,2022-08-16_14-25-12-556341,8893517,53,
8898557,8903698,2022-08-16_14-25-17-931198,8903714,5141,
8903737,8903811,2022-08-16_14-25-23-142036,8903815,74,
8908803,8908887,2022-08-16_14-25-28-350299,8908890,84,
8913945,0,,8919080,-8913945,
8919094,8924234,2022-08-16_14-25-39-008550,8924243,5140,
8924260,8924285,2022-08-16_14-25-44-142972,8924289,25,
8929399,8934512,2022-08-16_14-25-49-614089,8934516,5113,
8934517,8934542,2022-08-16_14-25-54-662410,8934545,25,
8939605,8944742,2022-08-16_14-25-59-896400,8944752,5137,
8944767,8949895,2022-08-16_14-26-05-310410,8949905,5128,
8949919,8955002,2022-08-16_14-26-10-483205,8955012,5083,
8955027,8955079,2022-08-16_14-26-15-730002,8955082,52,
8960137,8965252,2022-08-16_14-26-21-135023,8965262,5115,
8965277,
8970394,8975532,2022-08-16_14-26-31-626368,8975535,5138,
8975537,8975561,2022-08-16_14-26-36-747756,8975565,24,
8980688,8980738,2022-08-16_14-26-42-058034,8980741,50,
8985797,8990891,2022-08-16_14-26-47-378408,8990906,5094,
8990929,8991035,2022-08-16_14-26-52-620748,8995999,106,
8996014,9001131,2022-08-16_14-26-57-838780,9001141,5117,
9001161,9001196,2022-08-16_14-27-03-048058,9001199,35,
9006244,9011353,2022-08-16_14-27-10-034352,9011358,5109,
9011358,9011381,2022-08-16_14-27-13-494052,9011385,23,
9016516,9016573,2022-08-16_14-27-18-819099,9016576,57,
9021624,9021660,2022-08-16_14-27-24-040894,9021663,36,
9026730,9026768,2022-08-16_14-27-29-266362,9026771,38,
9031831,9031854,2022-08-16_14-27-34-498135,9031858,23,
9036940,9036966,2022-08-16_14-27-39-744002,9036969,26,
9042046,9042072,2022-08-16_14-27-44-979075,9042076,26,
9047154,9047229,2022-08-16_14-27-50-253301,9047232,75,
9052273,9052311,2022-08-16_14-27-55-476982,9052314,38,
9057379,9057404,2022-08-16_14-28-00-700316,9057407,25,
9062481,9062505,2022-08-16_14-28-05-931860,9062509,24,
9067620,9067713,2022-08-16_14-28-11-259460,9067719,93,
9072770,9072802,2022-08-16_14-28-16-490634,9072806,32,
9077874,9077897,2022-08-16_14-28-21-720205,9077901,23,
9083026,9083062,2022-08-16_14-28-27-019703,9083065,36,
9088125,9088176,2022-08-16_14-28-32-255128,9088179,51,
9093233,9093259,2022-08-16_14-28-37-476261,9093263,26,
9098358,9098426,2022-08-16_14-28-42-779543,9098431,68,
9103462,9103526,2022-08-16_14-28-48-008538,9103530,64,
9108592,9108634,2022-08-16_14-28-53-241711,9108639,42,
9113706,9113804,2022-08-16_14-28-58-557208,9113808,98,
9118837,9118891,2022-08-16_14-29-03-776962,9118894,54,
9123947,9123981,2022-08-16_14-29-08-999363,9123984,34,
9129052,9129085,2022-08-16_14-29-14-228265,9129091,33,
9134156,9134180,2022-08-16_14-29-19-466146,9134184,24,
9139305,9139328,2022-08-16_14-29-24-745122,9139332,23,
9144422,9149563,2022-08-16_14-29-30-094105,9149579,5141,
9149604,9149631,2022-08-16_14-29-35-316976,9149634,27,
9154687,9154727,2022-08-16_14-29-40-543043,9154730,40,
9159792,9159817,2022-08-16_14-29-45-765520,9159820,25,
9164892,9164916,2022-08-16_14-29-50-996992,9164920,24,
9170000,9170034,2022-08-16_14-29-56-247402,9170038,34,
9175105,9175131,2022-08-16_14-30-01-477234,9175134,26,
9180214,9180281,2022-08-16_14-30-06-763697,9180285,67,
9185325,9185364,2022-08-16_14-30-11-976555,9185368,39,
9190437,9190466,2022-08-16_14-30-17-210258,9190469,29,
9195545,9195570,2022-08-16_14-30-22-444299,9195574,25,
9200679,9205821,2022-08-16_14-30-27-711632,9205837,5142,
9205859,9205919,2022-08-16_14-30-33-064695,9205922,60,
9210962,9211008,2022-08-16_14-30-38-287921,9211011,46,
9216070,9216104,2022-08-16_14-30-43-516267,9216107,34,
9221177,9221296,2022-08-16_14-30-48-840541,9226276,119,
9226290,9226326,2022-08-16_14-30-54-001164,9226329,36,
9231441,9231470,2022-08-16_14-30-59-281131,9231473,29,
9236556,9236580,2022-08-16_14-31-04-525114,9236584,24,
9241681,9241704,2022-08-16_14-31-09-782508,9241707,23,
9246835,9246861,2022-08-16_14-31-15-069618,9246865,26,
9251973,9251997,2022-08-16_14-31-20-341196,9252001,24,
9257128,9257154,2022-08-16_14-31-25-631272,9257157,26,
9262277,9262322,2022-08-16_14-31-30-932095,9262325,45,
9267434,9267520,2022-08-16_14-31-36-256057,9267524,86,
9272532,9272558,2022-08-16_14-31-41-434601,9272561,26,
9277779,9277816,2022-08-16_14-31-46-832015,9277819,37,
9282910,9282937,2022-08-16_14-31-52-082834,9282941,27,
9288027,9288064,2022-08-16_14-31-57-347368,9288068,37,
9293198,9293296,2022-08-16_14-32-02-709185,9293299,98,
9298305,9298375,2022-08-16_14-32-07-924378,9298380,70,
9303412,9303444,2022-08-16_14-32-13-122469,9303447,32,
9308513,9308543,2022-08-16_14-32-18-351483,9308546,30,
9313619,0,,9318781,-9313619,
9318795,9318820,2022-08-16_14-32-28-901210,9318824,25,
9323893,9323926,2022-08-16_14-32-34-136820,9323929,33,
9329061,9329088,2022-08-16_14-32-39-435424,9329091,27,
9334204,9334230,2022-08-16_14-32-44-710044,9334234,26,
9339322,9339381,2022-08-16_14-32-49-981656,9339385,59,
9344420,9344444,2022-08-16_14-32-55-188501,9344447,24,
9349587,9349655,2022-08-16_14-33-00-528237,9349659,68,
9354694,9354739,2022-08-16_14-33-05-751350,9354742,45,
9359800,9359822,2022-08-16_14-33-10-967991,9359826,22,
9364967,9364994,2022-08-16_14-33-16-271918,9364997,27,
9370131,9370206,2022-08-16_14-33-21-623974,9370216,75,
9375239,9375295,2022-08-16_14-33-26-846996,9375300,56,
9380338,9380360,2022-08-16_14-33-32-047853,9380363,22,
9385493,9385580,2022-08-16_14-33-37-394408,9385584,87,
9390646,9390670,2022-08-16_14-33-42-623609,9390673,24,
9395786,9395811,2022-08-16_14-33-47-898324,9395814,25,
9400929,9400955,2022-08-16_14-33-53-176945,9400959,26,
9406029,9406051,2022-08-16_14-33-58-409129,9406054,22,
9411166,9411190,2022-08-16_14-34-03-680094,9411194,24,
9416275,9416301,2022-08-16_14-34-08-923561,9416304,26,
9421385,9421409,2022-08-16_14-34-14-165826,9421412,24,
9426537,9426561,2022-08-16_14-34-19-453834,9426564,24,
9431669,9431693,2022-08-16_14-34-24-718316,9431697,24,
9436816,9436894,2022-08-16_14-34-30-037868,9436900,78,
9441924,9441964,2022-08-16_14-34-35-249362,9441969,40,
9447034,9447058,2022-08-16_14-34-40-482384,9447061,24,
9452139,9452169,2022-08-16_14-34-45-728701,9452173,30,
9457248,9457272,2022-08-16_14-34-50-962684,9457276,24,
9462400,9462425,2022-08-16_14-34-56-248894,9462428,25,
9467524,9467550,2022-08-16_14-35-01-504389,9467553,26,
9472640,9472695,2022-08-16_14-35-06-789419,9472698,55,
9477768,9477794,2022-08-16_14-35-12-018185,9477797,26,
9482873,9482928,2022-08-16_14-35-17-277191,9482932,55,
9487998,9488022,2022-08-16_14-35-22-515000,9488026,24,
9493115,9493151,2022-08-16_14-35-27-781471,9493154,36,
9498220,9498243,2022-08-16_14-35-33-007000,9498247,23,
9503393,9508489,2022-08-16_14-35-38-341453,9508500,5096,
9508513,9508537,2022-08-16_14-35-43-571509,9508541,24,
9513619,9513642,2022-08-16_14-35-48-811673,9513645,23,
9518731,9518801,2022-08-16_14-35-54-098089,9518806,70,
9523841,9523889,2022-08-16_14-35-59-321748,9523893,48,
9528953,9534045,2022-08-16_14-36-04-645878,9534062,5092,
9534076,9534100,2022-08-16_14-36-09-802905,9534104,24,
9539169,9539193,2022-08-16_14-36-15-026127,9539198,24,
9544275,9544301,2022-08-16_14-36-20-267998,9544304,26,
9549430,9549460,2022-08-16_14-36-25-563261,9549470,30,
9554540,9554608,2022-08-16_14-36-30-846618,9554611,68,
9559646,9559686,2022-08-16_14-36-36-057982,9559690,40,
9564763,9564802,2022-08-16_14-36-41-306616,9564806,39,
9569868,9569912,2022-08-16_14-36-46-549987,9569916,44,
9574975,9574998,2022-08-16_14-36-51-773564,9575001,23,
9580084,9580165,2022-08-16_14-36-57-074916,9580169,81,
9585206,9585257,2022-08-16_14-37-02-300293,9585260,51,
9590322,9590347,2022-08-16_14-37-07-523877,9590350,25,
9595430,9595453,2022-08-16_14-37-12-763376,9595456,23,
9600538,9600566,2022-08-16_14-37-18-009826,9600569,28,
9605664,9605714,2022-08-16_14-37-23-296193,9605717,50,
9610769,9610802,2022-08-16_14-37-28-515854,9610806,33,
9615896,9615923,2022-08-16_14-37-33-766263,9615926,27,
9621018,9621041,2022-08-16_14-37-39-023309,9621045,23,
9626160,9626182,2022-08-16_14-37-44-302812,9626186,22,
9631260,9631283,2022-08-16_14-37-49-537843,9631286,23,
9636423,9636448,2022-08-16_14-37-54-836271,9636452,25,
9641571,9641627,2022-08-16_14-38-00-153894,9641631,56,
9646716,9646748,2022-08-16_14-38-05-403675,9646752,32,
9651868,9651910,2022-08-16_14-38-10-704228,9651913,42,
9656976,9662077,2022-08-16_14-38-16-026791,9662087,5101,
9662101,9662184,2022-08-16_14-38-21-249027,9662187,83,
9667199,9667271,2022-08-16_14-38-26-465684,9667278,72,
9672306,9672368,2022-08-16_14-38-31-694476,9672371,62,
9677476,9677499,2022-08-16_14-38-36-964107,9677503,23,
9682592,9682657,2022-08-16_14-38-42-253781,9682660,65,
9687701,9687732,2022-08-16_14-38-47-468633,9687735,31,
9692825,9692919,2022-08-16_14-38-52-747842,9692922,94,
9697985,9698013,2022-08-16_14-38-58-016231,9698017,28,
9703093,9703189,2022-08-16_14-39-03-328368,9703192,96,
9708191,9708217,2022-08-16_14-39-08-481242,9708221,26,
9713303,9713387,2022-08-16_14-39-13-782718,9713393,84,
9718485,9718570,2022-08-16_14-39-19-107971,9718574,85,
9723609,9723651,2022-08-16_14-39-24-319905,9723654,42,
9728716,9728798,2022-08-16_14-39-29-602405,9728801,82,
9733821,9733844,2022-08-16_14-39-34-777716,9733848,23,
9738924,9738950,2022-08-16_14-39-40-018193,9738953,26,
9744095,9744120,2022-08-16_14-39-45-321954,9744123,25,
9749204,9749304,2022-08-16_14-39-50-638956,9749308,100,
9754314,9754399,2022-08-16_14-39-55-870504,9754403,85,
9759429,9764527,2022-08-16_14-40-01-219866,9764530,5098,
9764531,9764555,2022-08-16_14-40-06-291054,9764559,24,
9769699,9769728,2022-08-16_14-40-11-598261,9769731,29,
9774816,9774841,2022-08-16_14-40-16-847122,9774844,25,
9779970,9780027,2022-08-16_14-40-22-171459,9780031,57,
9785080,9785133,2022-08-16_14-40-27-410442,9785135,53,
9790184,9790210,2022-08-16_14-40-32-619537,9790212,26,
9795297,9795415,2022-08-16_14-40-37-959290,9800403,118,
9800427,9800488,2022-08-16_14-40-43-168692,9800491,61,
9805518,9805593,2022-08-16_14-40-48-399682,9805599,75,
9810625,9810676,2022-08-16_14-40-53-625360,9810680,51,
9815735,9815765,2022-08-16_14-40-58-845324,9815769,30,
9820837,9820863,2022-08-16_14-41-04-076261,9820866,26,
9825982,9826050,2022-08-16_14-41-09-393234,9826055,68,
9831107,9831133,2022-08-16_14-41-14-616798,9831137,26,
9836207,9836229,2022-08-16_14-41-19-849246,9836232,22,
9841339,9841410,2022-08-16_14-41-25-165095,9841414,71,
9846464,9846493,2022-08-16_14-41-30-383431,9846496,29,
9851575,9851683,2022-08-16_14-41-35-710449,9856672,108,
9856687,9856788,2022-08-16_14-41-40-941023,9856795,101,
9861788,9861814,2022-08-16_14-41-46-108556,9861817,26,
9866904,9866951,2022-08-16_14-41-51-377909,9866955,47,
9872029,9872052,2022-08-16_14-41-56-617931,9872055,23,
9877136,9877231,2022-08-16_14-42-01-927191,9877237,95,
9882294,9882341,2022-08-16_14-42-07-176758,9882344,47,
9887409,9887432,2022-08-16_14-42-12-399045,9887435,23,
9892557,9892596,2022-08-16_14-42-17-697573,9892600,39,
9897659,9902759,2022-08-16_14-42-23-017312,9902769,5100,
9902793,9902875,2022-08-16_14-42-28-242035,9902879,82,
9907886,9907910,2022-08-16_14-42-33-406386,9907914,24,
9912997,9913061,2022-08-16_14-42-38-687017,9913065,64,
9918113,9918144,2022-08-16_14-42-43-909546,9918147,31,
9923215,9928364,2022-08-16_14-42-49-234609,9928374,5149,
9928390,9928414,2022-08-16_14-42-54-447946,9928418,24,
9933480,9933511,2022-08-16_14-42-59-678555,9933514,31,
9938587,9938611,2022-08-16_14-43-04-908704,9938614,24,
9943691,9943717,2022-08-16_14-43-10-143518,9943720,26,
9948802,9948885,2022-08-16_14-43-15-448804,9948889,83,
9953951,9953976,2022-08-16_14-43-20-673384,9953979,25,
9959061,9959085,2022-08-16_14-43-25-909896,9959088,24,
9964167,9964194,2022-08-16_14-43-31-148789,9964197,27,
9969274,9969300,2022-08-16_14-43-36-394155,9969303,26,
9974391,9974490,2022-08-16_14-43-41-717771,9974494,99,
9979478,9979517,2022-08-16_14-43-46-878353,9979520,39,
9984604,9984653,2022-08-16_14-43-52-131901,9984658,49,
9989708,9989738,2022-08-16_14-43-57-361431,9989742,30,
9994866,9994896,2022-08-16_14-44-02-657660,9994899,30,
10000013,10000036,2022-08-16_14-44-07-927430,10000039,23,
10005126,10005180,2022-08-16_14-44-13-206218,10005183,54,
10010232,10010261,2022-08-16_14-44-18-419880,10010264,29,
10015337,10015361,2022-08-16_14-44-23-651603,10015364,24,
10020448,10020472,2022-08-16_14-44-28-898780,10020475,24,
10025545,10025569,2022-08-16_14-44-34-130705,10025573,24,
10030683,10030713,2022-08-16_14-44-39-408594,10030716,30,
10035789,10035816,2022-08-16_14-44-44-642170,10035819,27,
10040896,10040921,2022-08-16_14-44-49-883295,10040924,25,
10046008,10046087,2022-08-16_14-44-55-185635,10046091,79,
10051122,10051192,2022-08-16_14-45-00-423184,10051197,70,
10056231,10056269,2022-08-16_14-45-05-630593,10056272,38,
10061341,10061363,2022-08-16_14-45-10-865462,10061366,22,
10066437,10066461,2022-08-16_14-45-16-093598,10066464,24,
10071555,10071640,2022-08-16_14-45-21-405405,10071644,85,
10076654,10076678,2022-08-16_14-45-26-578128,10076682,24,
10081807,10081834,2022-08-16_14-45-31-870277,10081838,27,
10086909,10086935,2022-08-16_14-45-37-103656,10086939,26,
10092024,10092095,2022-08-16_14-45-42-397379,10092098,71,
10097192,10097216,2022-08-16_14-45-47-655680,10097219,24,
10102309,10102369,2022-08-16_14-45-52-940533,10102372,60,
10107418,10107474,2022-08-16_14-45-58-181443,10107478,56,
10112521,10112547,2022-08-16_14-46-03-384299,10112551,26,
10117690,10117736,2022-08-16_14-46-08-710290,10117739,46,
10122799,10122835,2022-08-16_14-46-13-944191,10122838,36,
10127900,10127942,2022-08-16_14-46-19-185614,10127945,42,
10133070,10133107,2022-08-16_14-46-24-483110,10133111,37,
10138215,10138241,2022-08-16_14-46-29-752497,10138244,26,
10143365,10143405,2022-08-16_14-46-35-052932,10143408,40,
10148471,10148496,2022-08-16_14-46-40-274958,10148499,25,
10153579,10153610,2022-08-16_14-46-45-524739,10153615,31,
10158725,10158751,2022-08-16_14-46-50-800543,10158754,26,
10163873,10163899,2022-08-16_14-46-56-082838,10163909,26,
10168987,10169030,2022-08-16_14-47-01-344411,10169033,43,
10174127,10174155,2022-08-16_14-47-06-601699,10174158,28,
10179249,10179275,2022-08-16_14-47-11-857472,10179279,26,
10184364,10184396,2022-08-16_14-47-17-108077,10184399,32,
10189470,10189496,2022-08-16_14-47-22-341440,10189499,26,
10194571,10194594,2022-08-16_14-47-27-572459,10194598,23,
10199680,10199705,2022-08-16_14-47-32-819708,10199710,25,
10204798,10204849,2022-08-16_14-47-38-096795,10204852,51,
10209904,10209949,2022-08-16_14-47-43-328664,10209952,45,
10215013,10215040,2022-08-16_14-47-48-552024,10215044,27,
10220164,10220187,2022-08-16_14-47-53-836024,10220190,23,
10225295,10225322,2022-08-16_14-47-59-105784,10225326,27,
10230403,10230441,2022-08-16_14-48-04-342395,10230446,38,
10235511,10235535,2022-08-16_14-48-09-584332,10235540,24,
10240619,10240698,2022-08-16_14-48-14-868896,10240701,79,
10245739,10245762,2022-08-16_14-48-20-076868,10245765,23,
10250849,10250874,2022-08-16_14-48-25-325410,10250877,25,
10256020,10256053,2022-08-16_14-48-30-637034,10256056,33,
10261124,10266266,2022-08-16_14-48-36-073484,10266269,5142,
10266269,10266313,2022-08-16_14-48-41-160639,10266316,44,
10271377,10271401,2022-08-16_14-48-46-385123,10271404,24,
10276486,10276513,2022-08-16_14-48-51-629264,10276516,27,
10281639,10281700,2022-08-16_14-48-56-948569,10281703,61,
10286759,10286797,2022-08-16_14-49-02-177607,10286801,38,
10291868,10291898,2022-08-16_14-49-07-412674,10291901,30,
10297019,10297043,2022-08-16_14-49-12-692486,10297047,24,
10302149,10302174,2022-08-16_14-49-17-957152,10302177,25,
10307311,10307355,2022-08-16_14-49-23-272288,10307359,44,
10312420,10312447,2022-08-16_14-49-28-497458,10312450,27,
10317520,10317553,2022-08-16_14-49-33-737166,10317556,33,
10322667,10322690,2022-08-16_14-49-39-010310,10322694,23,
10327779,10327803,2022-08-16_14-49-44-254758,10327808,24,
10332948,10333008,2022-08-16_14-49-49-592227,10333012,60,
10338049,10338109,2022-08-16_14-49-54-825679,10338112,60,
10343160,10343266,2022-08-16_14-50-00-102989,10348257,106,
10348271,10348385,2022-08-16_14-50-05-301671,10353365,114,
10353379,10353430,2022-08-16_14-50-10-527588,10353434,51,
10358486,10363627,2022-08-16_14-50-15-930402,10363631,5141,
10363631,10363656,2022-08-16_14-50-21-040062,10363660,25,
10368789,10368834,2022-08-16_14-50-26-354514,10368838,45,
10373899,10373939,2022-08-16_14-50-31-583260,10373942,40,
10379004,10379028,2022-08-16_14-50-36-817783,10379031,24,
10384115,10384142,2022-08-16_14-50-42-055481,10384147,27,
10389230,10389288,2022-08-16_14-50-47-342983,10389292,58,
10394347,10394377,2022-08-16_14-50-52-564867,10394381,30,
10399450,10399479,2022-08-16_14-50-57-796016,10399484,29,
10404573,10404661,2022-08-16_14-51-03-112870,10404665,88,
10409688,10409753,2022-08-16_14-51-08-335487,10409756,65,
10414843,10414867,2022-08-16_14-51-13-589121,10414871,24,
10419993,10420030,2022-08-16_14-51-18-884357,10420033,37,
10425149,10425222,2022-08-16_14-51-24-209853,10425225,73,
10430291,10430318,2022-08-16_14-51-29-439292,10430322,27,
10435395,10435419,2022-08-16_14-51-34-675017,10435422,24,
10440504,10440586,2022-08-16_14-51-39-976761,10440590,82,
10445620,10445677,2022-08-16_14-51-45-199402,10445680,57,
10450719,10450743,2022-08-16_14-51-50-399819,10450747,24,
10455855,10455880,2022-08-16_14-51-55-668842,10455883,25,
10460993,10461028,2022-08-16_14-52-00-948886,10461031,35,
10466147,10466170,2022-08-16_14-52-06-227569,10466173,23,
10471302,10471329,2022-08-16_14-52-11-520936,10471332,27,
10476410,10476434,2022-08-16_14-52-16-757913,10476438,24,
10481562,10481587,2022-08-16_14-52-22-045452,10481590,25,
10486730,10486759,2022-08-16_14-52-27-348717,10486762,29,
10491876,10491908,2022-08-16_14-52-32-627265,10491912,32,
10497012,10497039,2022-08-16_14-52-37-901685,10497042,27,
10502118,10502167,2022-08-16_14-52-43-153156,10502170,49,
10507237,10507288,2022-08-16_14-52-48-413765,10507292,51,
10512376,10512404,2022-08-16_14-52-53-659284,10512408,28,
10517509,10517536,2022-08-16_14-52-58-924203,10517540,27,
10522660,10522690,2022-08-16_14-53-04-207402,10522693,30,
10527796,10527823,2022-08-16_14-53-09-471522,10527827,27,
10532951,10532975,2022-08-16_14-53-14-765880,10532978,24,
10538059,10538101,2022-08-16_14-53-20-023406,10538105,42,
10543193,10543217,2022-08-16_14-53-25-270879,10543221,24,
10548338,10548363,2022-08-16_14-53-30-549652,10548366,25,
10553480,10553505,2022-08-16_14-53-35-826806,10553508,25,
10558587,10558611,2022-08-16_14-53-41-067291,10558615,24,
10563718,10563741,2022-08-16_14-53-46-329525,10563745,23,
10568863,10568890,2022-08-16_14-53-51-608885,10568893,27,
10574040,10574062,2022-08-16_14-53-56-912501,10574065,22,
10579168,10579191,2022-08-16_14-54-02-174639,10579195,23,
10584274,10584298,2022-08-16_14-54-07-407925,10584302,24,
10589561,10589585,2022-08-16_14-54-12-829413,10589589,24,
10594668,10594692,2022-08-16_14-54-18-071455,10594696,24,
10599776,10599798,2022-08-16_14-54-23-311857,10599802,22,
10604930,10604954,2022-08-16_14-54-28-603796,10604957,24,
10610062,10610085,2022-08-16_14-54-33-866067,10610089,23,
10615168,10615194,2022-08-16_14-54-39-107005,10615197,26,
10620275,10620301,2022-08-16_14-54-44-344976,10620304,26,
10625435,10625458,2022-08-16_14-54-49-637166,10625461,23,
10630549,10630574,2022-08-16_14-54-54-884438,10630577,25,
10635655,10635680,2022-08-16_14-55-00-120995,10635683,25,
10640763,10640787,2022-08-16_14-55-05-357035,10640791,24,
10645891,10645917,2022-08-16_14-55-10-617141,10645921,26,
10651000,10651024,2022-08-16_14-55-15-855357,10651027,24,
10656174,10656200,2022-08-16_14-55-21-162677,10656203,26,
10661329,10661353,2022-08-16_14-55-26-450794,10661364,24,
10666435,10666460,2022-08-16_14-55-31-684563,10666464,25,
10671545,10671568,2022-08-16_14-55-36-924802,10671572,23,
10676652,10676679,2022-08-16_14-55-42-164577,10676683,27,
10681768,10681792,2022-08-16_14-55-47-412545,10681795,24,
10686876,10686904,2022-08-16_14-55-52-652486,10686908,28,
10691984,10692008,2022-08-16_14-55-57-894057,10692012,24,
10697158,10697183,2022-08-16_14-56-03-204252,10697188,25,
10702265,10702289,2022-08-16_14-56-08-440015,10702293,24,
10707373,10707397,2022-08-16_14-56-13-675026,10707401,24,
10712481,10712515,2022-08-16_14-56-18-924642,10712519,34,
10717595,10717619,2022-08-16_14-56-24-165211,10717623,24,
10722697,10722722,2022-08-16_14-56-29-398871,10722725,25,
10727805,10727830,2022-08-16_14-56-34-639681,10727833,25,
10732913,10732937,2022-08-16_14-56-39-875768,10732940,24,
10738021,10738047,2022-08-16_14-56-45-113855,10738051,26,
10743130,10743154,2022-08-16_14-56-50-358332,10743159,24,
10748263,10748287,2022-08-16_14-56-55-622535,10748291,24,
10753371,10753395,2022-08-16_14-57-00-860185,10753399,24,
10758479,10758503,2022-08-16_14-57-06-098638,10758506,24,
10763586,10763611,2022-08-16_14-57-11-339067,10763614,25,
10768694,10768717,2022-08-16_14-57-16-578831,10768720,23,
10773840,10773866,2022-08-16_14-57-21-857827,10773870,26,
10779016,10779040,2022-08-16_14-57-27-163036,10779043,24,
10784122,10784148,2022-08-16_14-57-32-401934,10784151,26,
10789293,10789319,2022-08-16_14-57-37-708603,10789322,26,
10794394,10794420,2022-08-16_14-57-42-941944,10794423,26,
10799502,10799528,2022-08-16_14-57-48-178432,10799531,26,
10804655,10804679,2022-08-16_14-57-53-464232,10804682,24,
10809763,10809813,2022-08-16_14-57-58-731458,10809817,50,
10814875,10814903,2022-08-16_14-58-03-947953,10814906,28,
10820004,10820030,2022-08-16_14-58-09-207605,10820033,26,
10825133,10825158,2022-08-16_14-58-14-470813,10825161,25,
10830264,10830288,2022-08-16_14-58-19-733388,10830292,24,
10835412,10835437,2022-08-16_14-58-25-013202,10835440,25,
10840554,10840579,2022-08-16_14-58-30-283208,10840583,25,
10845695,10845719,2022-08-16_14-58-35-560682,10845723,24,
10850808,10850834,2022-08-16_14-58-40-804965,10850837,26,
10855938,10855964,2022-08-16_14-58-46-067418,10855967,26,
10861079,10861107,2022-08-16_14-58-51-337418,10861110,28,
10866204,10866229,2022-08-16_14-58-56-597298,10866233,25,
10871331,10871360,2022-08-16_14-59-01-855753,10871364,29,
10876461,10876486,2022-08-16_14-59-07-115127,10876489,25,
10881568,10881591,2022-08-16_14-59-12-351373,10881594,23,
10886725,10886751,2022-08-16_14-59-17-641415,10886754,26,
10891832,10891857,2022-08-16_14-59-22-882282,10891862,25,
10896958,10896981,2022-08-16_14-59-28-136541,10896984,23,
10902120,10902146,2022-08-16_14-59-33-430949,10902149,26,
10907254,10907285,2022-08-16_14-59-38-696190,10907288,31,
10912393,10912417,2022-08-16_14-59-43-969737,10912422,24,
10917527,10917551,2022-08-16_14-59-49-232979,10917554,24,
10922665,10922689,2022-08-16_14-59-54-505037,10922694,24,
10927815,10927840,2022-08-16_14-59-59-785930,10927843,25,
10932974,10933001,2022-08-16_15-00-05-080357,10933005,27,
10938122,10938147,2022-08-16_15-00-10-362104,10938150,25,
10943269,10943294,2022-08-16_15-00-15-638405,10943298,25,
10948407,10948432,2022-08-16_15-00-20-907958,10948435,25,
10953516,10953543,2022-08-16_15-00-26-151946,10953546,27,
10958670,10958695,2022-08-16_15-00-31-439896,10958698,25,
10963787,10963812,2022-08-16_15-00-36-686434,10963815,25,
10968924,10968948,2022-08-16_15-00-41-957939,10968951,24,
10974058,10974084,2022-08-16_15-00-47-223385,10974088,26,
10979223,10979283,2022-08-16_15-00-52-556270,10979286,60,
10984329,10984357,2022-08-16_15-00-57-756947,10984361,28,
10989447,10989471,2022-08-16_15-01-03-006055,10989475,24,
10994566,10994628,2022-08-16_15-01-08-297573,10994633,62,
10999670,10999730,2022-08-16_15-01-13-526276,10999735,60,
11004824,11004914,2022-08-16_15-01-18-843481,11004917,90,
11009917,11009941,2022-08-16_15-01-24-003788,11009945,24,
11015083,11015108,2022-08-16_15-01-29-300415,11015111,25,
11020202,11020232,2022-08-16_15-01-34-552358,11020235,30,
11025316,11025398,2022-08-16_15-01-39-845577,11025401,82,
11030427,11030477,2022-08-16_15-01-45-065633,11030480,50,
11035534,11035567,2022-08-16_15-01-50-281745,11035571,33,
11040641,11040666,2022-08-16_15-01-55-514881,11040669,25,
11045743,11045778,2022-08-16_15-02-00-756800,11045782,35,
11050860,11050951,2022-08-16_15-02-06-057282,11050955,91,
11055961,11056034,2022-08-16_15-02-11-279578,11056038,73,
11061087,11061118,2022-08-16_15-02-16-495591,11061121,31,
11066185,11066213,2022-08-16_15-02-21-718572,11066216,28,
11071299,11071339,2022-08-16_15-02-26-975826,11071343,40,
11076407,11076498,2022-08-16_15-02-32-265926,11076502,91,
11081549,11081589,2022-08-16_15-02-37-489852,11081592,40,
11086657,11086684,2022-08-16_15-02-42-718717,11086687,27,
11091795,11091820,2022-08-16_15-02-47-986471,11091823,25,
11096895,11096919,2022-08-16_15-02-53-214354,11096922,24,
11102012,11102058,2022-08-16_15-02-58-486370,11102061,46,
11107116,11107146,2022-08-16_15-03-03-704128,11107149,30,
11112219,